County_name,State_name,County_code,Year,Total_population,Total_households,Female_population,Male_population,Median_age,Median_household_income_past_12m,Bachelor_degree,Master_degree,Professional_degree,Doctorate_degree,Num_employed,Num_unemployed,Labor_force,Avg_household_size,Median_value_owner_occupied_housing,Median_gross_rent,Households_no_internet,Households_internet_subscription,Households_solar_energy_fuel,Num_under_18,Num_18_to_34,Num_35_to_64,Num_65_more,Num_industry_agriculture_fishing_hunting,Calculated_Total,Total_matches
"Merced County, California",06,047,2011,253606,74079,125935,127671,29.5,43945,,,,,94066,16875,110941,3.37,197700,806,,,42,80678,64432,85077,23419,10964,253606,True
"Mariposa County, California",06,043,2011,18290,7607,9031,9259,48.4,49174,,,,,7602,1152,8754,2.28,248900,748,,,28,3382,2850,8311,3747,243,18290,True
"Yuba County, California",06,115,2011,71817,23885,35565,36252,31.7,46617,,,,,25417,5218,30635,2.95,194200,829,,,10,20968,18084,25691,7074,1077,71817,True
"Contra Costa County, California",06,013,2011,1037817,370925,531217,506600,38.3,79135,,,,,483584,50498,534082,2.77,490200,1309,,,203,259160,213627,437493,127537,2076,1037817,True
"Lassen County, California",06,035,2011,35001,10097,12016,22985,37.0,52484,,,,,10453,1157,11610,2.43,199200,855,,,13,6093,10438,15111,3359,490,35001,True
"Stanislaus County, California",06,099,2011,512469,164933,258699,253770,32.6,50671,,,,,205958,34207,240165,3.07,232000,962,,,65,148069,123333,187176,53891,10688,512469,True
"Sonoma County, California",06,097,2011,478551,184170,243235,235316,39.7,64343,,,,,232866,22146,255012,2.54,477300,1223,,,407,106283,105015,201651,65602,6660,478551,True
"Tehama County, California",06,103,2011,62985,23810,31665,31320,39.4,38753,,,,,22885,3601,26486,2.6,208000,813,,,15,16180,12303,24495,10007,1877,62985,True
"Mono County, California",06,051,2011,14016,5416,6462,7554,36.5,60469,,,,,8001,650,8651,2.53,428600,1096,,,0,2963,3709,6082,1262,313,14016,True
"San Benito County, California",06,069,2011,54873,16785,27456,27417,33.9,65570,,,,,24917,3081,27998,3.23,432900,1202,,,22,16141,12066,21338,5328,2343,54873,True
"Sacramento County, California",06,067,2011,1408480,510976,718323,690157,34.7,56553,,,,,621437,82587,704024,2.7,285000,1003,,,128,362686,347130,542377,156287,3613,1408480,True
"El Dorado County, California",06,017,2011,179878,68812,89822,90056,43.1,68815,,,,,83412,8986,92398,2.6,409400,1098,,,61,41496,30311,82528,25543,827,179878,True
"Monterey County, California",06,053,2011,411385,125217,199720,211665,32.8,59737,,,,,175425,21210,196635,3.14,497400,1160,,,127,110356,107181,150344,43504,26118,411385,True
"Sierra County, California",06,091,2011,3277,1328,1702,1575,51.5,50308,,,,,1300,165,1465,2.42,304700,913,,,0,554,356,1676,691,80,3277,True
"Lake County, California",06,033,2011,64392,25654,31934,32458,44.3,39525,,,,,24493,3792,28285,2.46,235900,891,,,0,13843,11243,28135,11171,1110,64392,True
"Modoc County, California",06,049,2011,9587,3947,4765,4822,46.5,35402,,,,,3573,369,3942,2.28,162500,613,,,0,2120,1490,4123,1854,714,9587,True
"Inyo County, California",06,027,2011,18457,7910,9128,9329,45.1,49571,,,,,8737,664,9401,2.3,271100,882,,,9,3986,3172,7829,3470,126,18457,True
"Santa Barbara County, California",06,083,2011,419793,141635,209144,210649,33.4,61896,,,,,195736,17659,213395,2.84,523800,1303,,,188,96726,120550,148731,53786,15951,419793,True
"Imperial County, California",06,025,2011,171343,48117,82858,88485,31.8,39402,,,,,58017,11406,69423,3.34,169600,699,,,0,50261,42644,60562,17876,5306,171343,True
"Alameda County, California",06,001,2011,1494876,536160,761579,733297,36.4,70821,,,,,718035,72802,790837,2.73,558300,1228,,,664,339631,373709,617075,164461,1771,1494876,True
"Napa County, California",06,055,2011,135377,49640,67925,67452,39.5,68641,,,,,64899,5636,70535,2.63,521700,1279,,,67,31335,28580,55126,20336,3947,135377,True
"San Francisco County, California",06,075,2011,797983,338366,393493,404490,38.4,72947,,,,,447467,36368,483835,2.3,767300,1388,,,506,107294,242100,339312,109277,925,797983,True
"Colusa County, California",06,011,2011,21297,6989,10307,10990,33.5,49558,,,,,8853,1414,10267,2.98,244200,885,,,8,6356,4624,7782,2535,1778,21297,True
"Kings County, California",06,031,2011,152335,40716,65944,86391,31.0,48838,,,,,52895,7973,60868,3.33,208100,864,,,0,42256,43470,54741,11868,8591,152335,True
"Fresno County, California",06,019,2011,920623,285338,460507,460116,30.6,46903,,,,,367858,53357,421215,3.16,236400,850,,,287,276004,237876,314877,91866,35698,920623,True
"Orange County, California",06,059,2011,2989948,987164,1510337,1479611,36.0,75762,,,,,1441313,130490,1571803,2.99,575100,1463,,,521,738138,712905,1196784,342121,6485,2989948,True
"Sutter County, California",06,101,2011,94192,31668,47331,46861,34.4,50010,,,,,37995,6307,44302,2.94,233000,867,,,8,26055,21696,34669,11772,3161,94192,True
"San Joaquin County, California",06,077,2011,680277,212902,341182,339095,32.5,53764,,,,,269072,45417,314489,3.11,264600,993,,,83,200978,160391,249085,69823,12985,680277,True
"San Diego County, California",06,073,2011,3060849,1064048,1524649,1536200,34.6,63857,,,,,1382856,135379,1518235,2.79,455000,1261,,,1155,721299,826855,1166987,345708,11091,3060849,True
"Tulare County, California",06,107,2011,436234,128324,217568,218666,29.5,43550,,,,,167498,26039,193537,3.35,191500,781,,,24,142404,107538,145284,41008,28949,436234,True
"Yolo County, California",06,113,2011,198889,69860,101903,96986,30.1,57920,,,,,91834,9918,101752,2.74,365500,1086,,,89,44929,67189,67435,19336,3407,198889,True
"Humboldt County, California",06,023,2011,133585,53724,66688,66897,37.3,40376,,,,,59407,6413,65820,2.4,314400,859,,,36,26920,36399,52821,17445,2462,133585,True
"Nevada County, California",06,057,2011,98392,41561,49525,48867,47.3,58077,,,,,44232,4497,48729,2.35,412600,1138,,,71,19295,15631,44696,18770,563,98392,True
"Alpine County, California",06,003,2011,1167,357,562,605,40.4,59018,,,,,529,52,581,3.25,395600,796,,,2,284,219,531,133,6,1167,True
"Madera County, California",06,039,2011,149611,42032,77555,72056,33.2,47724,,,,,52804,6736,59540,3.34,245500,861,,,4,42650,35838,54289,16834,9408,149611,True
"Mendocino County, California",06,045,2011,87525,34102,43569,43956,41.4,44527,,,,,38812,4791,43603,2.5,380800,940,,,148,19511,17555,37003,13456,2259,87525,True
"Santa Cruz County, California",06,087,2011,259402,93834,130019,129383,36.7,66030,,,,,127947,11698,139645,2.67,613500,1325,,,195,55018,69584,106310,28490,7334,259402,True
"Trinity County, California",06,105,2011,13711,5731,6595,7116,49.3,37672,,,,,4841,835,5676,2.34,264200,744,,,5,2546,2144,6415,2606,255,13711,True
"Los Angeles County, California",06,037,2011,9787747,3218518,4961111,4826636,34.6,56266,,,,,4501382,489810,4991192,2.99,478300,1161,,,1589,2427831,2523996,3786926,1048994,19102,9787747,True
"Riverside County, California",06,065,2011,2154844,672896,1081389,1073455,33.5,58365,,,,,868898,128528,997426,3.15,284100,1141,,,262,616909,500321,785058,252556,12706,2154844,True
"San Bernardino County, California",06,071,2011,2023452,598822,1016261,1007191,31.4,55853,,,,,815102,120253,935355,3.3,278400,1092,,,348,598000,508298,740171,176983,5426,2023452,True
"Santa Clara County, California",06,085,2011,1762754,599652,877447,885307,36.0,89064,,,,,850552,80286,930838,2.89,681100,1459,,,682,425396,426342,718594,192422,4183,1762754,True
"Marin County, California",06,041,2011,250666,102832,127211,123455,44.3,89605,,,,,124781,8459,133240,2.34,840900,1571,,,317,51785,38938,118961,40982,907,250666,True
"Placer County, California",06,061,2011,343554,130736,175725,167829,40.0,74645,,,,,157609,14002,171611,2.61,387400,1190,,,221,84378,64637,142569,51970,802,343554,True
"Siskiyou County, California",06,093,2011,44687,19782,22442,22245,46.9,37865,,,,,16929,2626,19555,2.22,232200,758,,,16,9276,7362,19345,8704,1071,44687,True
"Shasta County, California",06,089,2011,177231,69147,90049,87182,41.6,44058,,,,,69420,9839,79259,2.51,246800,882,,,24,40201,35523,72172,29335,1833,177231,True
"Solano County, California",06,095,2011,411620,139312,205858,205762,36.7,69914,,,,,181725,20179,201904,2.82,340100,1222,,,137,102270,95042,168632,45676,2575,411620,True
"Del Norte County, California",06,015,2011,28561,9818,12873,15688,38.9,37588,,,,,9316,1054,10370,2.55,239800,869,,,0,6343,6440,11768,4010,270,28561,True
"Glenn County, California",06,021,2011,28027,9483,13899,14128,35.3,43239,,,,,11107,1238,12345,2.91,233800,742,,,0,7892,6021,10469,3645,1875,28027,True
"Butte County, California",06,007,2011,219309,85219,110868,108441,37.2,42971,,,,,87965,13399,101364,2.5,254900,878,,,21,46172,58835,80856,33446,2888,219309,True
"Plumas County, California",06,063,2011,20192,9434,9962,10230,49.0,44151,,,,,7948,1319,9267,2.1,266100,779,,,14,3735,2991,9394,4072,633,20192,True
"San Luis Obispo County, California",06,079,2011,267871,101993,130470,137401,39.1,58630,,,,,121788,10733,132521,2.47,480200,1165,,,203,50655,71951,105021,40244,3636,267871,True
"Kern County, California",06,029,2011,829254,250999,401201,428053,30.6,48021,,,,,312748,44613,357361,3.16,196000,840,,,90,252072,211943,291078,74161,33452,829254,True
"Ventura County, California",06,111,2011,815745,264982,410329,405416,36.2,76728,,,,,384192,34914,419106,3.03,515900,1428,,,249,212140,183773,325648,94184,16802,815745,True
"Calaveras County, California",06,009,2011,45794,18865,22933,22861,49.0,55256,,,,,18391,1857,20248,2.4,312000,1031,,,22,9038,6424,20831,9501,477,45794,True
"San Mateo County, California",06,081,2011,711622,256423,361789,349833,39.2,87633,,,,,362719,28750,391469,2.74,763100,1508,,,154,158182,153435,305100,94905,2515,711622,True
"Tuolumne County, California",06,109,2011,55736,22157,26366,29370,47.2,47359,,,,,20559,3086,23645,2.32,304700,905,,,2,9922,10396,24280,11138,566,55736,True
"Amador County, California",06,005,2011,38244,14283,17384,20860,48.0,56180,,,,,13260,2381,15641,2.35,318400,1011,,,23,6473,6154,17965,7652,319,38244,True
"Merced County, California",06,047,2012,256398,74496,127267,129131,29.7,43565,12085.0,3754.0,1961.0,401.0,94612,18179,112791,3.38,161600,832,,,27,80508,65657,85956,24277,11852,256398,True
"Mariposa County, California",06,043,2012,18193,7256,9063,9130,49.4,52584,1961.0,532.0,193.0,91.0,7399,1279,8678,2.38,242900,797,,,27,3202,2814,8312,3865,214,18193,True
"Yuba County, California",06,115,2012,72244,24133,35664,36580,31.9,46641,4266.0,1176.0,404.0,125.0,25143,5553,30696,2.94,180700,870,,,7,20902,18246,25795,7301,1249,72244,True
"Contra Costa County, California",06,013,2012,1052047,373145,538606,513441,38.5,78187,173014.0,64802.0,21327.0,13043.0,487081,54436,541517,2.79,433800,1340,,,292,259693,217723,442053,132578,2691,1052047,True
"Lassen County, California",06,035,2012,34628,10127,11947,22681,37.4,51921,2320.0,657.0,295.0,83.0,10299,1299,11598,2.4,189400,873,,,15,5723,10478,14936,3491,498,34628,True
"Stanislaus County, California",06,099,2012,515115,165999,260313,254802,32.8,49866,34234.0,10996.0,4389.0,1488.0,204032,37836,241868,3.06,192200,978,,,75,147089,124361,188201,55464,10747,515115,True
"Sonoma County, California",06,097,2012,483456,184502,245696,237760,39.8,63565,68323.0,25179.0,8782.0,3919.0,232479,24660,257139,2.56,430900,1243,,,416,106075,106957,202021,68403,6963,483456,True
"Tehama County, California",06,103,2012,63200,23552,31772,31428,39.6,40307,3890.0,1008.0,463.0,137.0,22769,4055,26824,2.64,189500,824,,,13,16034,12443,24570,10153,1736,63200,True
"Mono County, California",06,051,2012,14181,5056,6665,7516,37.1,61868,2001.0,647.0,151.0,18.0,7872,940,8812,2.75,355600,1146,,,28,3013,3609,6199,1360,223,14181,True
"San Benito County, California",06,069,2012,55467,16840,27774,27693,34.1,63939,4685.0,1084.0,403.0,120.0,24640,3707,28347,3.26,361700,1266,,,20,16012,12302,21631,5522,2068,55467,True
"Sacramento County, California",06,067,2012,1422348,512496,725562,696786,34.9,55846,172480.0,54086.0,19794.0,9260.0,616044,92296,708340,2.72,249800,1019,,,146,362464,351372,547393,161119,4065,1422348,True
"El Dorado County, California",06,017,2012,180441,67846,90019,90422,43.5,70117,26975.0,8419.0,2869.0,1287.0,82758,10131,92889,2.64,378400,1109,,,67,40805,30792,82063,26781,916,180441,True
"Monterey County, California",06,053,2012,416199,125123,202109,214090,32.9,60143,36833.0,15155.0,4482.0,3392.0,176109,21905,198014,3.18,390400,1183,,,78,111291,108639,151441,44828,27448,416199,True
"Sierra County, California",06,091,2012,3163,1338,1611,1552,51.6,42500,273.0,124.0,15.0,0.0,1253,126,1379,2.32,265600,1026,,,0,529,357,1588,689,93,3163,True
"Butte County, California",06,007,2012,220101,85074,111140,108961,37.3,43339,22359.0,7246.0,2598.0,1585.0,87362,14647,102009,2.52,237400,885,,,37,46039,59177,80797,34088,2813,220101,True
"Plumas County, California",06,063,2012,19926,9109,9895,10031,49.4,45358,2123.0,979.0,139.0,198.0,7728,1605,9333,2.14,251200,844,,,0,3627,3107,8922,4270,653,19926,True
"San Luis Obispo County, California",06,079,2012,270121,101708,131802,138319,39.3,59628,34965.0,13802.0,4423.0,3147.0,122615,11642,134257,2.49,449300,1197,,,192,50680,72414,105527,41500,3600,270121,True
"Kern County, California",06,029,2012,839153,253178,406669,432484,30.7,47727,48758.0,16911.0,5069.0,2430.0,314751,47548,362299,3.18,171200,869,,,164,253669,215717,293669,76098,34568,839153,True
"Ventura County, California",06,111,2012,822794,265951,413994,408800,36.4,76483,104852.0,41320.0,12367.0,6769.0,386464,39640,426104,3.05,465600,1447,,,256,211012,186658,327470,97654,16721,822794,True
"Calaveras County, California",06,009,2012,45507,18618,22636,22871,49.5,54686,4988.0,1373.0,513.0,142.0,17908,2403,20311,2.41,276200,1043,,,29,8765,6405,20521,9816,361,45507,True
"San Mateo County, California",06,081,2012,721183,257369,366455,354728,39.3,87751,135711.0,55332.0,17241.0,14075.0,367761,30935,398696,2.76,734100,1541,,,177,159384,155597,308602,97600,2348,721183,True
"Tuolumne County, California",06,109,2012,55205,22105,26241,28964,48.0,48169,4675.0,1742.0,433.0,335.0,19998,3856,23854,2.31,282500,922,,,19,9613,10290,23887,11415,618,55205,True
"Amador County, California",06,005,2012,37764,14236,17222,20542,48.4,53462,4042.0,825.0,417.0,138.0,12498,2615,15113,2.33,286500,1039,,,19,6327,5993,17582,7862,295,37764,True
"Orange County, California",06,059,2012,3021840,990266,1526713,1495127,36.2,75566,472441.0,168387.0,53938.0,29212.0,1448768,143451,1592219,3.01,537600,1482,,,526,736684,722868,1208016,354272,6191,3021840,True
"Sutter County, California",06,101,2012,94615,31635,47541,47074,34.5,50510,7975.0,1948.0,774.0,243.0,37640,6564,44204,2.96,204200,869,,,5,25917,21949,34608,12141,3354,94615,True
"San Joaquin County, California",06,077,2012,687036,213632,344916,342120,32.6,53895,51142.0,14862.0,5391.0,2810.0,269936,50234,320170,3.14,225400,1021,,,97,200868,162543,251469,72156,13145,687036,True
"San Diego County, California",06,073,2012,3100500,1067462,1544043,1556457,34.7,63373,430264.0,168867.0,52316.0,40544.0,1386825,147839,1534664,2.82,419400,1282,,,1389,723484,840442,1180394,356180,11585,3100500,True
"Tulare County, California",06,107,2012,441877,129996,220306,221571,29.7,43803,22355.0,7059.0,2951.0,1004.0,169283,27688,196971,3.35,172100,805,,,71,143399,109349,147031,42098,29487,441877,True
"Yolo County, California",06,113,2012,200873,70090,102853,98020,30.5,57260,23575.0,10469.0,4604.0,5581.0,91506,10200,101706,2.75,329000,1085,,,136,45294,66868,68679,20032,3284,200873,True
"Humboldt County, California",06,023,2012,134317,53307,67030,67287,37.5,40830,15839.0,5233.0,1458.0,1287.0,59383,6868,66251,2.43,300400,869,,,26,26894,36586,52967,17870,2430,134317,True
"Nevada County, California",06,057,2012,98521,41626,49597,48924,48.0,57382,15768.0,5335.0,1849.0,891.0,42883,4981,47864,2.34,379900,1135,,,63,18886,15909,44273,19453,677,98521,True
"Alpine County, California",06,003,2012,1197,385,528,669,43.2,59931,142.0,76.0,14.0,22.0,542,62,604,3.07,371300,755,,,2,270,211,569,147,5,1197,True
"Madera County, California",06,039,2012,150615,42063,78058,72557,33.2,47937,9116.0,2479.0,873.0,379.0,52135,6837,58972,3.37,210300,888,,,3,42818,36091,54227,17479,9715,150615,True
"Mendocino County, California",06,045,2012,87577,34228,43647,43930,41.7,43721,7952.0,3526.0,1188.0,385.0,38095,4909,43004,2.49,353400,954,,,121,19366,17468,36753,13990,2217,87577,True
"Santa Cruz County, California",06,087,2012,262340,93310,131527,130813,36.9,66571,39033.0,16327.0,4287.0,3909.0,128218,12305,140523,2.71,576500,1380,,,194,55109,70533,107010,29688,7659,262340,True
"Trinity County, California",06,105,2012,13693,5811,6678,7015,49.2,36569,1482.0,399.0,87.0,61.0,4654,892,5546,2.3,258800,741,,,12,2652,2067,6234,2740,169,13693,True
"Los Angeles County, California",06,037,2012,9840024,3218511,4987765,4852259,34.8,56241,1228908.0,418357.0,153053.0,79355.0,4495118,544607,5039725,3.0,443300,1187,,,1746,2402354,2544374,3814741,1078555,19796,9840024,True
"Riverside County, California",06,065,2012,2192982,676618,1101058,1091924,33.7,57096,178679.0,67662.0,18309.0,11101.0,869427,143984,1013411,3.19,248100,1163,,,334,618744,512958,799687,261593,12808,2192982,True
"San Bernardino County, California",06,071,2012,2041029,599698,1025530,1015499,31.7,54750,147554.0,55110.0,14504.0,8654.0,806463,131841,938304,3.33,241500,1099,,,292,593753,515790,747656,183830,5406,2041029,True
"Santa Clara County, California",06,085,2012,1788393,604455,890380,898013,36.2,90747,309774.0,172758.0,31646.0,38474.0,858467,88035,946502,2.91,656600,1508,,,659,429068,430579,729538,199208,4018,1788393,True
"Marin County, California",06,041,2012,252759,103152,128329,124430,44.6,90962,58767.0,26266.0,11411.0,5040.0,125414,9363,134777,2.36,810700,1598,,,259,52097,39322,118566,42774,973,252759,True
"Placer County, California",06,061,2012,350074,131775,179091,170983,40.2,73356,56361.0,18089.0,5541.0,2547.0,156831,16127,172958,2.63,354900,1220,,,276,84976,66181,144449,54468,765,350074,True
"Siskiyou County, California",06,093,2012,44673,19585,22411,22262,47.0,37948,4974.0,1671.0,555.0,232.0,16542,2848,19390,2.25,215200,792,,,9,9195,7502,19057,8919,1127,44673,True
"Shasta County, California",06,089,2012,177693,68880,90251,87442,41.9,44396,15894.0,5039.0,1790.0,742.0,68502,10871,79373,2.53,233400,916,,,31,39757,35987,71650,30299,1876,177693,True
"Solano County, California",06,095,2012,414209,140295,207318,206891,37.0,69006,46392.0,13380.0,4258.0,1892.0,181736,22548,204284,2.83,290500,1249,,,175,101147,96348,169158,47556,2535,414209,True
"Del Norte County, California",06,015,2012,28496,9703,12819,15677,38.8,39626,1864.0,510.0,141.0,212.0,9381,1291,10672,2.57,227700,865,,,0,6061,6772,11595,4068,304,28496,True
"Glenn County, California",06,021,2012,28078,9540,13871,14207,36.5,42641,1931.0,508.0,217.0,56.0,10917,1285,12202,2.9,222300,740,,,0,7824,5787,10761,3706,1775,28078,True
"Lake County, California",06,033,2012,64360,26103,31831,32529,44.8,38147,5524.0,1566.0,390.0,211.0,23786,4312,28098,2.42,200500,864,,,12,13628,11395,27960,11377,1284,64360,True
"Modoc County, California",06,049,2012,9545,3903,4716,4829,46.8,37482,903.0,245.0,106.0,72.0,3630,475,4105,2.3,158200,614,,,0,2109,1443,4066,1927,683,9545,True
"Inyo County, California",06,027,2012,18474,7910,9078,9396,45.7,45000,1738.0,780.0,221.0,65.0,8911,699,9610,2.29,246200,889,,,9,3920,3203,7829,3522,160,18474,True
"Santa Barbara County, California",06,083,2012,423594,141247,210932,212662,33.6,62723,48443.0,21108.0,6557.0,6322.0,195057,19197,214254,2.87,482400,1326,,,198,97452,121289,149981,54872,16387,423594,True
"Imperial County, California",06,025,2012,173487,47928,84169,89318,31.8,41255,9309.0,3221.0,878.0,261.0,58215,12743,70958,3.4,155800,725,,,12,50535,43232,61357,18363,5230,173487,True
"Alameda County, California",06,001,2012,1515136,539179,772143,742993,36.6,71516,249246.0,116816.0,27561.0,27987.0,725920,79870,805790,2.75,514900,1265,,,751,340863,379251,624885,170137,1982,1515136,True
"Napa County, California",06,055,2012,136644,49209,68438,68206,39.6,69571,19110.0,6365.0,2503.0,1056.0,65382,6416,71798,2.68,460400,1297,,,79,31338,28963,55479,20864,4322,136644,True
"San Francisco County, California",06,075,2012,807755,340839,397952,409803,38.5,73802,198019.0,80683.0,30763.0,15241.0,450004,39369,489373,2.31,750900,1447,,,566,108353,245475,342910,111017,841,807755,True
"Colusa County, California",06,011,2012,21329,6884,10310,11019,33.9,52165,1430.0,231.0,77.0,24.0,8729,1472,10201,3.03,210300,904,,,15,6352,4603,7826,2548,2014,21329,True
"Kings County, California",06,031,2012,151982,40767,66483,85499,31.2,48761,8459.0,2123.0,699.0,140.0,51920,8797,60717,3.3,192000,874,,,0,42185,42792,54861,12144,8205,151982,True
"Fresno County, California",06,019,2012,930517,287082,465614,464903,30.7,45741,71394.0,21783.0,9196.0,3569.0,364567,59171,423738,3.18,212100,864,,,350,276998,241066,318074,94379,37615,930517,True
"San Diego County, California",06,073,2013,3138265,1076483,1562170,1576095,34.8,62962,439641.0,174933.0,52249.0,40484.0,1390197,155014,1545211,2.83,402100,1300,,,1799,724796,852960,1192563,367946,11736,3138265,True
"Tulare County, California",06,107,2013,446644,131642,222623,224021,29.9,42708,22449.0,7606.0,2800.0,1001.0,168845,28726,197571,3.35,163100,821,,,79,143945,110907,148490,43302,30193,446644,True
"Yolo County, California",06,113,2013,202288,70347,103609,98679,30.7,55918,23710.0,10886.0,4465.0,5462.0,90984,10585,101569,2.76,314300,1082,,,150,45308,67142,69034,20804,3838,202288,True
"Humboldt County, California",06,023,2013,134613,53296,67156,67457,37.5,41426,16877.0,4950.0,1607.0,1436.0,59294,7426,66720,2.44,288300,889,,,55,26678,36714,52812,18409,2408,134613,True
"Nevada County, California",06,057,2013,98509,40991,49615,48894,48.5,57353,15589.0,5345.0,1963.0,806.0,42077,5022,47099,2.38,357300,1217,,,102,18462,16101,43749,20197,667,98509,True
"Alpine County, California",06,003,2013,1165,394,457,708,44.3,58636,154.0,55.0,13.0,32.0,467,51,518,2.9,333600,1018,,,0,254,180,505,226,5,1165,True
"Madera County, California",06,039,2013,151435,42516,78302,73133,33.2,45625,8882.0,2514.0,858.0,388.0,52029,6203,58232,3.37,182000,914,,,11,42869,36536,54092,17938,10586,151435,True
"Mendocino County, California",06,045,2013,87497,33878,43591,43906,41.8,43469,8329.0,3548.0,1063.0,538.0,37335,5123,42458,2.52,323600,953,,,101,19176,17384,36388,14549,2225,87497,True
"Santa Cruz County, California",06,087,2013,264808,93504,132958,131850,36.9,66519,38868.0,16524.0,4048.0,3788.0,127850,13123,140973,2.72,557500,1385,,,234,55214,71630,106960,31004,7460,264808,True
"Trinity County, California",06,105,2013,13638,5668,6670,6968,49.8,36890,1707.0,374.0,77.0,63.0,4552,854,5406,2.35,257400,758,,,7,2467,2078,6183,2910,110,13638,True
"Los Angeles County, California",06,037,2013,9893481,3230383,5014833,4878648,35.1,55909,1254787.0,427211.0,152969.0,81313.0,4489974,580531,5070505,3.01,420200,1204,,,2091,2371472,2566688,3844299,1111022,19643,9893481,True
"Riverside County, California",06,065,2013,2228528,683144,1118837,1109691,33.9,56529,181572.0,70877.0,18483.0,11224.0,877030,153115,1030145,3.21,231000,1168,,,498,617524,526531,812943,271530,13032,2228528,True
"San Bernardino County, California",06,071,2013,2056915,603879,1033530,1023385,31.9,54090,150285.0,57453.0,13948.0,9121.0,801850,136314,938164,3.33,222300,1102,,,355,588407,523720,753510,191278,5491,2056915,True
"Santa Clara County, California",06,085,2013,1812208,609377,902012,910196,36.4,91702,314485.0,180189.0,33067.0,39545.0,865327,92839,958166,2.92,645600,1566,,,820,431785,433997,739894,206532,4774,1812208,True
"Marin County, California",06,041,2013,254643,102912,129539,125104,44.8,90839,58348.0,26823.0,11585.0,5358.0,124625,10206,134831,2.39,781900,1628,,,315,52556,39543,117918,44626,802,254643,True
"Placer County, California",06,061,2013,355924,132709,182215,173709,40.4,72725,57421.0,19025.0,5937.0,2801.0,157675,17525,175200,2.66,342000,1242,,,320,85385,67404,145974,57161,740,355924,True
"Siskiyou County, California",06,093,2013,44503,19417,22284,22219,47.1,37709,5225.0,1683.0,515.0,243.0,16329,2862,19191,2.26,200800,802,,,14,9135,7568,18652,9148,1305,44503,True
"Shasta County, California",06,089,2013,177966,68980,90366,87600,42.1,44651,15334.0,5242.0,1649.0,802.0,67746,10488,78234,2.54,220000,919,,,31,39313,36444,70874,31335,1624,177966,True
"Solano County, California",06,095,2013,417258,141464,209012,208246,37.1,67177,46834.0,13229.0,4616.0,2252.0,182801,25056,207857,2.85,262400,1264,,,306,100236,97830,169420,49772,2486,417258,True
"Del Norte County, California",06,015,2013,28357,9593,12624,15733,39.1,37909,1746.0,617.0,134.0,245.0,9006,1268,10274,2.58,198400,914,,,0,6063,6584,11684,4026,359,28357,True
"Glenn County, California",06,021,2013,28054,9628,13860,14194,37.2,43023,1778.0,550.0,195.0,62.0,10813,1584,12397,2.87,217700,720,,,0,7754,5673,10815,3812,1852,28054,True
"Butte County, California",06,007,2013,220542,84816,111342,109200,37.0,43752,22977.0,7340.0,2590.0,1599.0,87159,14353,101512,2.53,225900,890,,,52,45761,59877,80054,34850,2795,220542,True
"Plumas County, California",06,063,2013,19586,8997,9776,9810,49.9,45794,1940.0,987.0,204.0,197.0,7461,1551,9012,2.13,243700,799,,,0,3558,3117,8576,4335,826,19586,True
"San Luis Obispo County, California",06,079,2013,272094,102154,132979,139115,39.5,58697,35579.0,13615.0,4357.0,3095.0,122909,11360,134269,2.5,426600,1211,,,228,50889,73254,104967,42984,3927,272094,True
"Kern County, California",06,029,2013,848204,255271,411556,436648,30.8,48552,49384.0,17620.0,4877.0,2706.0,317047,50233,367280,3.19,161700,885,,,316,254390,219459,296061,78294,36181,848204,True
"Ventura County, California",06,111,2013,829017,267076,417296,411721,36.6,76544,106166.0,42413.0,12769.0,7311.0,389297,41171,430468,3.06,442200,1470,,,369,209433,189360,328873,101351,17894,829017,True
"Calaveras County, California",06,009,2013,45147,18702,22535,22612,50.0,55295,5044.0,1451.0,447.0,178.0,17598,2307,19905,2.38,254800,1061,,,32,8610,6399,20041,10097,313,45147,True
"San Mateo County, California",06,081,2013,729543,257941,370583,358960,39.3,88202,137435.0,57517.0,18326.0,14495.0,371212,32594,403806,2.79,722200,1602,,,225,160568,157101,311368,100506,2329,729543,True
"Tuolumne County, California",06,109,2013,54728,22025,25935,28793,48.0,48426,5335.0,1841.0,633.0,206.0,18988,3965,22953,2.31,269400,919,,,36,9423,10387,23254,11664,532,54728,True
"Amador County, California",06,005,2013,37422,14262,17186,20236,49.1,53684,4104.0,902.0,398.0,171.0,12609,2546,15155,2.32,270500,1006,,,3,6066,5917,17293,8146,204,37422,True
"Merced County, California",06,047,2013,258707,75409,128196,130511,30.0,42591,12444.0,3689.0,1776.0,720.0,93207,20299,113506,3.36,146400,860,,,82,80203,66544,86774,25186,11800,258707,True
"Mariposa County, California",06,043,2013,18061,7238,8990,9071,50.1,49820,1999.0,600.0,223.0,84.0,7365,1239,8604,2.36,235000,866,,,0,3124,2947,8021,3969,183,18061,True
"Yuba County, California",06,115,2013,72574,24300,35632,36942,31.9,44902,4380.0,1134.0,401.0,123.0,24078,5776,29854,2.93,171000,863,,,10,20862,18394,25762,7556,1268,72574,True
"Contra Costa County, California",06,013,2013,1065794,375855,545574,520220,38.6,78756,178698.0,65884.0,21427.0,13328.0,491161,56720,547881,2.81,404000,1365,,,410,260120,221773,445850,138051,2458,1065794,True
"Lassen County, California",06,035,2013,34018,9945,11463,22555,37.3,53107,2218.0,669.0,242.0,104.0,9583,1509,11092,2.36,185500,867,,,23,5414,10573,14527,3504,458,34018,True
"Stanislaus County, California",06,099,2013,518321,166883,261770,256551,33.0,49297,35149.0,11229.0,4324.0,1402.0,203232,40996,244228,3.07,172900,992,,,55,146284,125513,189315,57209,11612,518321,True
"Sonoma County, California",06,097,2013,487469,185660,247808,239661,40.2,63356,70116.0,25228.0,9152.0,3949.0,232206,26411,258617,2.57,407400,1265,,,583,105145,108120,202644,71560,7007,487469,True
"Tehama County, California",06,103,2013,63241,23374,31806,31435,39.9,41924,3734.0,1258.0,487.0,194.0,22495,4217,26712,2.66,177100,821,,,29,15804,12584,24477,10376,1540,63241,True
"Mono County, California",06,051,2013,14217,5268,6654,7563,37.2,61757,1889.0,700.0,304.0,14.0,7852,904,8756,2.65,344500,1118,,,16,2988,3643,6102,1484,271,14217,True
"San Benito County, California",06,069,2013,56115,16995,28064,28051,34.5,66237,4702.0,1133.0,420.0,103.0,24793,3971,28764,3.28,343000,1233,,,51,15826,12517,22011,5761,1723,56115,True
"Sacramento County, California",06,067,2013,1435207,517243,732421,702786,35.1,55064,174232.0,56896.0,20167.0,9251.0,610662,97193,707855,2.72,234200,1024,,,213,361727,354841,551804,166835,4145,1435207,True
"El Dorado County, California",06,017,2013,180982,67885,90406,90576,44.1,69297,27370.0,8999.0,2844.0,1426.0,81175,11030,92205,2.64,359500,1090,,,146,40128,31190,81537,28127,895,180982,True
"Monterey County, California",06,053,2013,420569,125428,204224,216345,33.0,59168,37138.0,15556.0,4407.0,3212.0,174453,21545,195998,3.2,362400,1209,,,144,111948,109667,152684,46270,27298,420569,True
"Sierra County, California",06,091,2013,3127,1253,1630,1497,51.3,39009,403.0,32.0,21.0,0.0,1140,129,1269,2.45,231400,1040,,,0,515,342,1622,648,90,3127,True
"Santa Barbara County, California",06,083,2013,427288,141720,212746,214542,33.5,62779,48533.0,21173.0,6701.0,6018.0,196190,20352,216542,2.89,453000,1340,,,196,97839,123159,150112,56178,16910,427288,True
"Imperial County, California",06,025,2013,175201,48099,85118,90083,31.8,41807,9603.0,3344.0,760.0,230.0,58169,13214,71383,3.42,147300,744,,,13,50858,43897,61484,18962,5252,175201,True
"Alameda County, California",06,001,2013,1535248,545071,782408,752840,36.8,72112,256881.0,121868.0,28461.0,28998.0,732923,84354,817277,2.76,493800,1289,,,865,341314,384008,633226,176700,2027,1535248,True
"Napa County, California",06,055,2013,137837,49431,69116,68721,39.8,70443,19438.0,6430.0,2465.0,1023.0,66087,6625,72712,2.69,428600,1350,,,187,31324,29455,55584,21474,3983,137837,True
"San Francisco County, California",06,075,2013,817501,345344,402218,415283,38.5,75604,201608.0,84503.0,31408.0,15373.0,456845,41148,497993,2.31,744600,1488,,,475,109537,247972,346862,113130,855,817501,True
"Colusa County, California",06,011,2013,21366,6853,10302,11064,33.9,52158,1480.0,177.0,126.0,25.0,8653,1322,9975,3.07,181600,923,,,19,6236,4699,7820,2611,2175,21366,True
"Kings County, California",06,031,2013,151806,40785,66687,85119,31.1,48133,8745.0,2087.0,846.0,159.0,51566,9249,60815,3.28,176900,871,,,39,42150,42540,54626,12490,8265,151806,True
"Fresno County, California",06,019,2013,939605,289811,470401,469204,30.9,45563,72578.0,22333.0,9354.0,4028.0,363912,61663,425575,3.18,195400,875,,,579,277524,244059,320834,97188,37380,939605,True
"Orange County, California",06,059,2013,3051771,995512,1542097,1509674,36.4,75422,480104.0,173290.0,55730.0,29727.0,1453951,150339,1604290,3.02,519600,1498,,,669,732841,732211,1219342,367377,5996,3051771,True
"Sutter County, California",06,101,2013,94787,31725,47704,47083,34.8,50408,7973.0,2070.0,890.0,243.0,37230,6552,43782,2.95,188500,889,,,14,25728,21934,34628,12497,3402,94787,True
"San Joaquin County, California",06,077,2013,693177,215563,348072,345105,32.9,53380,52122.0,15242.0,5410.0,3266.0,270795,52165,322960,3.14,208000,1026,,,139,199991,164648,253875,74663,13049,693177,True
"Lake County, California",06,033,2013,64260,26505,31894,32366,45.1,36548,5248.0,1573.0,359.0,242.0,22718,4488,27206,2.38,183600,900,,,13,13341,11681,27465,11773,1168,64260,True
"Modoc County, California",06,049,2013,9468,3983,4691,4777,46.9,36212,927.0,194.0,93.0,61.0,3635,434,4069,2.23,164100,633,,,0,2069,1448,3983,1968,605,9468,True
"Inyo County, California",06,027,2013,18482,7873,9170,9312,45.7,44796,1749.0,714.0,267.0,132.0,8692,826,9518,2.3,236100,829,,,9,3881,3267,7770,3564,260,18482,True
"Lake County, California",06,033,2014,64209,26771,31910,32299,45.2,35997,4935.0,1745.0,420.0,344.0,22288,4452,26740,2.36,167900,921,,,24,13209,11750,27089,12161,1238,64209,True
"Modoc County, California",06,049,2014,9335,3893,4608,4727,47.1,38560,955.0,144.0,95.0,59.0,3517,495,4012,2.25,157300,671,,,0,1981,1491,3886,1977,544,9335,True
"Inyo County, California",06,027,2014,18439,7891,9171,9268,45.3,45625,1800.0,730.0,190.0,115.0,8336,713,9049,2.27,235200,835,,,0,3879,3318,7583,3659,223,18439,True
"Santa Barbara County, California",06,083,2014,431555,142028,215185,216370,33.6,63409,49596.0,21078.0,6943.0,5951.0,198675,19444,218119,2.91,446500,1357,,,263,98110,124841,150825,57779,16458,431555,True
"Imperial County, California",06,025,2014,177026,46952,86290,90736,31.9,41772,9993.0,3361.0,718.0,132.0,57838,12765,70603,3.55,145200,772,,,12,50993,44506,61706,19821,5450,177026,True
"Alameda County, California",06,001,2014,1559308,551734,795343,763965,36.9,73775,262854.0,127775.0,29431.0,29385.0,749786,79503,829289,2.77,509300,1325,,,966,342075,390709,642338,184186,2338,1559308,True
"Napa County, California",06,055,2014,139253,49631,69952,69301,40.3,70925,20343.0,6486.0,2502.0,1152.0,67312,6162,73474,2.71,439000,1376,,,225,31079,29712,56191,22271,4114,139253,True
"San Francisco County, California",06,075,2014,829072,348832,407556,421516,38.6,78378,208286.0,87685.0,31068.0,15524.0,466640,38318,504958,2.32,765700,1533,,,576,111188,251471,350340,116073,685,829072,True
"Colusa County, California",06,011,2014,21424,6912,10268,11156,34.1,50503,1491.0,225.0,150.0,30.0,8755,1239,9994,3.06,174500,864,,,15,6169,4738,7838,2679,2235,21424,True
"Kings County, California",06,031,2014,151390,41108,67157,84233,31.2,47341,8265.0,2065.0,1000.0,114.0,50951,8426,59377,3.24,170000,875,,,54,41869,42604,54076,12841,8097,151390,True
"Fresno County, California",06,019,2014,948844,292550,475417,473427,31.2,45201,73566.0,22909.0,8743.0,4395.0,367392,61422,428814,3.18,191700,884,,,842,277827,246176,324277,100564,37490,948844,True
"Orange County, California",06,059,2014,3086331,1002285,1561260,1525071,36.7,75998,494995.0,179886.0,57096.0,30554.0,1478643,142427,1621070,3.04,532300,1522,,,819,729650,741001,1233518,382162,5979,3086331,True
"Sutter County, California",06,101,2014,95067,31723,47804,47263,35.0,51527,7916.0,2127.0,788.0,318.0,37377,6075,43452,2.96,189600,898,,,22,25534,21997,34536,13000,3607,95067,True
"San Joaquin County, California",06,077,2014,701050,217343,352434,348616,33.2,53253,53111.0,15921.0,5186.0,3305.0,275581,48592,324173,3.15,211300,1033,,,392,199585,166781,256997,77687,13650,701050,True
"Merced County, California",06,047,2014,261609,76516,129710,131899,30.2,43066,12985.0,4009.0,1706.0,885.0,94994,20181,115175,3.35,152600,870,,,83,80126,67567,87801,26115,12368,261609,True
"Mariposa County, California",06,043,2014,17946,7289,8896,9050,50.2,50560,2006.0,696.0,228.0,126.0,7454,1132,8586,2.33,240300,838,,,0,3095,2991,7653,4207,190,17946,True
"Yuba County, California",06,115,2014,73059,24712,36039,37020,32.1,45470,4443.0,1365.0,384.0,136.0,24794,5203,29997,2.9,170800,884,,,12,20780,18540,25794,7945,1497,73059,True
"Contra Costa County, California",06,013,2014,1081232,380183,554058,527174,38.7,79799,183654.0,68914.0,21514.0,13504.0,499984,54315,554299,2.82,417400,1395,,,780,260195,226208,450405,144424,2648,1081232,True
"Lassen County, California",06,035,2014,33356,9821,10999,22357,37.3,53351,1999.0,695.0,318.0,113.0,9411,1458,10869,2.3,176500,901,,,31,5012,10657,14059,3628,429,33356,True
"Stanislaus County, California",06,099,2014,522794,168090,264176,258618,33.3,49573,35408.0,11419.0,4635.0,1368.0,205219,40070,245289,3.07,175400,993,,,203,145775,126523,191036,59460,11115,522794,True
"Sonoma County, California",06,097,2014,491790,186935,250461,241329,40.5,63799,72304.0,25309.0,9416.0,4201.0,235040,24894,259934,2.58,414500,1302,,,595,104532,108931,203192,75135,6801,491790,True
"Tehama County, California",06,103,2014,63284,23480,31790,31494,40.0,42369,4048.0,1276.0,520.0,159.0,22521,4315,26836,2.65,170300,833,,,60,15579,12622,24400,10683,1536,63284,True
"Mono County, California",06,051,2014,14193,5160,6673,7520,37.2,61814,2322.0,588.0,309.0,0.0,7520,1014,8534,2.7,324600,1061,,,8,2875,3661,6055,1602,353,14193,True
"San Benito County, California",06,069,2014,56888,17121,28460,28428,34.8,67874,4849.0,1262.0,481.0,169.0,25260,4124,29384,3.3,357200,1265,,,66,15788,12771,22377,5952,1843,56888,True
"Sierra County, California",06,091,2014,3019,1291,1538,1481,53.5,43107,371.0,74.0,12.0,0.0,1203,91,1294,2.31,195700,1010,,,0,501,304,1517,697,78,3019,True
"Sacramento County, California",06,067,2014,1450277,519460,740598,709679,35.3,55615,176972.0,59253.0,20863.0,10029.0,619316,93301,712617,2.74,236500,1035,,,409,361130,358444,557027,173676,4651,1450277,True
"El Dorado County, California",06,017,2014,181465,67220,90721,90744,44.4,68507,27179.0,9224.0,2953.0,1649.0,79965,10215,90180,2.67,356900,1073,,,261,39455,31521,80923,29566,838,181465,True
"Monterey County, California",06,053,2014,424927,125115,206867,218060,33.3,58582,37596.0,15924.0,4471.0,3441.0,175455,18709,194164,3.24,362100,1228,,,206,112718,109955,154359,47895,29122,424927,True
"San Diego County, California",06,073,2014,3183143,1083811,1584877,1598266,34.9,63996,455144.0,181805.0,53877.0,42120.0,1421325,150837,1572162,2.85,412800,1328,,,2352,726898,867145,1206921,382179,12785,3183143,True
"Tulare County, California",06,107,2014,451108,132706,225227,225881,30.1,42863,23091.0,7420.0,2887.0,868.0,170819,26687,197506,3.36,161000,826,,,81,144268,111904,150203,44733,32857,451108,True
"Yolo County, California",06,113,2014,204162,70953,104634,99528,31.0,55508,23414.0,11716.0,4518.0,6049.0,91643,9738,101381,2.76,317700,1096,,,281,45257,67625,69558,21722,3698,204162,True
"Humboldt County, California",06,023,2014,134876,53130,67343,67533,37.4,42153,16786.0,5169.0,1629.0,1411.0,58838,7512,66350,2.46,281300,899,,,101,26524,36726,52550,19076,2452,134876,True
"Nevada County, California",06,057,2014,98606,40838,49794,48812,48.8,56949,15724.0,5484.0,2063.0,877.0,41788,4993,46781,2.39,344800,1190,,,95,18115,16349,43041,21101,585,98606,True
"Alpine County, California",06,003,2014,1202,377,537,665,43.6,61343,153.0,47.0,11.0,46.0,505,32,537,3.11,313800,775,,,0,235,245,497,225,4,1202,True
"Madera County, California",06,039,2014,152452,42723,79002,73450,33.3,45490,8858.0,2452.0,895.0,457.0,52544,5530,58074,3.37,179100,937,,,50,42835,36662,54530,18425,10895,152452,True
"Los Angeles County, California",06,037,2014,9974203,3242391,5060515,4913688,35.3,55870,1281851.0,442258.0,153552.0,83602.0,4548646,564669,5113315,3.02,425100,1221,,,2640,2347600,2590990,3885720,1149893,20712,9974203,True
"Mendocino County, California",06,045,2014,87612,33693,43633,43979,42.0,43290,8930.0,3227.0,1152.0,463.0,36957,5193,42150,2.53,310300,972,,,86,19216,17310,35968,15118,2131,87612,True
"Santa Cruz County, California",06,087,2014,267203,94219,134386,132817,36.9,66923,39582.0,16915.0,4353.0,3716.0,129416,12376,141792,2.72,559500,1427,,,244,54991,72722,106878,32612,7089,267203,True
"Trinity County, California",06,105,2014,13515,5521,6630,6885,50.0,36862,1748.0,430.0,63.0,45.0,4668,698,5366,2.39,258500,802,,,7,2384,2077,6069,2985,123,13515,True
"Riverside County, California",06,065,2014,2266899,690388,1138975,1127924,34.2,56592,188561.0,73494.0,19204.0,11808.0,895237,149759,1044996,3.24,236400,1182,,,726,616767,538903,828541,282688,14234,2266899,True
"San Bernardino County, California",06,071,2014,2078586,607604,1044825,1033761,32.2,54100,151858.0,60071.0,14483.0,9367.0,812707,131293,944000,3.34,225400,1113,,,513,584394,532408,762022,199762,5598,2078586,True
"Santa Clara County, California",06,085,2014,1841569,614714,916721,924848,36.6,93854,324301.0,189646.0,33585.0,41452.0,888761,85977,974738,2.94,664100,1637,,,1055,434411,440181,752262,214715,5122,1841569,True
"Marin County, California",06,041,2014,256802,103034,130964,125838,45.1,91529,58107.0,27681.0,11635.0,5917.0,126429,9756,136185,2.41,785100,1659,,,351,52816,39795,117553,46638,744,256802,True
"Placer County, California",06,061,2014,361518,134111,185028,176490,40.7,73747,59598.0,19691.0,6064.0,3073.0,159811,16469,176280,2.67,345900,1277,,,434,85402,68591,147520,60005,724,361518,True
"Siskiyou County, California",06,093,2014,44261,19380,22240,22021,47.3,37495,5173.0,1860.0,410.0,220.0,16225,2725,18950,2.25,185400,799,,,55,9062,7554,18282,9363,1336,44261,True
"Shasta County, California",06,089,2014,178520,68961,90828,87692,41.9,44556,15358.0,5446.0,1844.0,1004.0,67871,9445,77316,2.54,213700,932,,,32,39105,36743,70286,32386,1481,178520,True
"Solano County, California",06,095,2014,421624,142521,211723,209901,37.2,67341,47620.0,13014.0,4821.0,2536.0,183876,25256,209132,2.87,263600,1290,,,402,99575,99791,169947,52311,2350,421624,True
"Del Norte County, California",06,015,2014,28066,9527,12503,15563,39.2,39302,2022.0,642.0,174.0,265.0,8668,1246,9914,2.57,180100,843,,,0,5984,6504,11426,4152,328,28066,True
"Glenn County, California",06,021,2014,28019,9561,13815,14204,36.7,40106,1916.0,558.0,246.0,77.0,10534,1641,12175,2.89,214600,716,,,21,7655,5932,10533,3899,1912,28019,True
"Butte County, California",06,007,2014,221578,85215,111833,109745,36.9,43165,23653.0,7585.0,2738.0,1532.0,88274,13323,101597,2.54,220100,899,,,155,45530,60727,79611,35710,2728,221578,True
"Plumas County, California",06,063,2014,19286,8529,9532,9754,50.6,48032,1956.0,906.0,290.0,173.0,7259,1455,8714,2.21,231400,824,,,0,3342,3116,8361,4467,650,19286,True
"San Luis Obispo County, California",06,079,2014,274184,102350,134238,139946,39.5,59454,36175.0,14387.0,4299.0,3299.0,122252,10667,132919,2.52,426200,1226,,,265,50725,74343,104370,44746,3556,274184,True
"Kern County, California",06,029,2014,857730,257737,417018,440712,31.0,48574,51067.0,17956.0,5099.0,2765.0,321221,49041,370262,3.2,161800,887,,,443,255295,222443,299195,80797,37589,857730,True
"Ventura County, California",06,111,2014,835790,267829,421512,414278,36.9,77335,108296.0,43588.0,12323.0,7646.0,394105,40806,434911,3.07,444800,1494,,,412,208063,191246,330882,105599,19559,835790,True
"Calaveras County, California",06,009,2014,44921,18608,22664,22257,50.3,54936,5034.0,1517.0,353.0,176.0,17212,2191,19403,2.38,242600,1072,,,42,8398,6448,19612,10463,362,44921,True
"San Mateo County, California",06,081,2014,739837,258683,375946,363891,39.4,91421,140683.0,59754.0,19275.0,15044.0,379767,30371,410138,2.82,736800,1664,,,265,161600,159506,314825,103906,2424,739837,True
"Tuolumne County, California",06,109,2014,54347,22181,25924,28423,48.2,48493,5528.0,1709.0,576.0,305.0,19455,3481,22936,2.28,262600,924,,,65,9153,10445,22826,11923,507,54347,True
"Amador County, California",06,005,2014,37159,13939,17193,19966,49.6,52964,4095.0,1067.0,534.0,181.0,12402,2342,14744,2.36,251800,1029,,,23,5979,5741,16976,8463,183,37159,True
"Merced County, California",06,047,2015,263885,77692,130733,133152,30.4,42462,13248.0,4382.0,1382.0,922.0,96170,18650,114820,3.32,161200,873,,,128,79992,68321,88623,26949,12960,263885,True
"Mariposa County, California",06,043,2015,17789,7345,8858,8931,50.6,47681,1889.0,717.0,251.0,167.0,7329,963,8292,2.29,235900,812,,,15,2983,2930,7573,4303,238,17789,True
"Yuba County, California",06,115,2015,73437,25139,36137,37300,32.1,46892,4455.0,1489.0,401.0,128.0,25499,4424,29923,2.87,172100,885,,,47,20652,18790,25838,8157,1319,73437,True
"Contra Costa County, California",06,013,2015,1096068,384646,561450,534618,38.8,80185,187160.0,70929.0,21753.0,14077.0,509920,48995,558915,2.82,439900,1426,,,1130,260467,230269,454501,150831,2642,1096068,True
"Lassen County, California",06,035,2015,32645,9707,10827,21818,37.0,51555,1925.0,615.0,309.0,80.0,9082,1109,10191,2.24,172900,882,,,53,4916,10494,13499,3736,521,32645,True
"Stanislaus County, California",06,099,2015,527367,169196,266322,261045,33.5,50125,36060.0,11818.0,4588.0,1515.0,208428,37259,245687,3.08,190800,989,,,296,145559,127636,192126,62046,11313,527367,True
"Sonoma County, California",06,097,2015,495078,187782,252261,242817,40.8,64240,73923.0,25770.0,9668.0,4499.0,240247,21168,261415,2.59,436400,1320,,,591,103689,109191,203182,79016,7910,495078,True
"Tehama County, California",06,103,2015,63152,23704,31663,31489,40.5,41001,4105.0,1364.0,501.0,193.0,23127,3511,26638,2.63,171500,782,,,74,15281,12511,24422,10938,1629,63152,True
"Mono County, California",06,051,2015,14146,4906,6835,7311,38.5,56944,2243.0,536.0,332.0,21.0,7061,1094,8155,2.82,313000,1068,,,9,2822,3610,5833,1881,386,14146,True
"San Benito County, California",06,069,2015,57557,17198,28784,28773,35.0,71077,4834.0,1373.0,452.0,214.0,26261,3636,29897,3.33,380200,1353,,,71,15773,12991,22530,6263,1800,57557,True
"Sacramento County, California",06,067,2015,1465832,522596,748715,717117,35.5,55987,184008.0,61344.0,22112.0,9891.0,633897,84904,718801,2.76,248400,1036,,,629,360744,361840,561961,181287,5087,1465832,True
"El Dorado County, California",06,017,2015,182093,67086,91123,90970,44.9,69584,26827.0,9686.0,3165.0,1673.0,79568,9925,89493,2.69,363000,1054,,,359,38825,31880,80341,31047,842,182093,True
"Monterey County, California",06,053,2015,428441,125402,209142,219299,33.5,58783,38266.0,15719.0,4563.0,3617.0,177333,16358,193691,3.26,369100,1236,,,272,113389,110033,155340,49679,30827,428441,True
"Sierra County, California",06,091,2015,3021,1252,1516,1505,54.5,42833,360.0,69.0,21.0,9.0,1110,96,1206,2.38,170400,938,,,0,463,332,1489,737,79,3021,True
"San Diego County, California",06,073,2015,3223096,1094157,1604151,1618945,35.1,64309,470339.0,190165.0,56309.0,43493.0,1462130,139302,1601432,2.86,429600,1344,,,3174,727474,879304,1218644,397674,13106,3223096,True
"Tulare County, California",06,107,2015,454033,133570,226607,227426,30.3,42031,24805.0,7467.0,2843.0,953.0,170780,23322,194102,3.36,162700,830,,,232,144013,112673,151235,46112,33058,454033,True
"Yolo County, California",06,113,2015,207320,71997,106383,100937,30.9,54989,23810.0,12402.0,4405.0,6422.0,92806,9225,102031,2.77,325700,1102,,,416,45366,69328,69869,22757,3636,207320,True
"Humboldt County, California",06,023,2015,135034,53036,67501,67533,37.4,42197,16774.0,5384.0,1664.0,1533.0,58449,6868,65317,2.47,279300,892,,,106,26444,36746,51950,19894,2550,135034,True
"Nevada County, California",06,057,2015,98570,40993,49902,48668,49.0,56521,16003.0,5976.0,2038.0,875.0,41473,4524,45997,2.38,347000,1191,,,165,17810,16504,42246,22010,456,98570,True
"Alpine County, California",06,003,2015,1131,358,477,654,43.6,52917,112.0,50.0,10.0,38.0,408,49,457,3.06,295000,913,,,0,251,223,433,224,0,1131,True
"Madera County, California",06,039,2015,153187,43159,79324,73863,33.5,45073,8876.0,2503.0,777.0,486.0,53032,4280,57312,3.35,189700,926,,,51,42771,36659,54652,19105,10545,153187,True
"Mendocino County, California",06,045,2015,87544,34017,43717,43827,42.2,42980,9648.0,3098.0,1136.0,617.0,36848,5107,41955,2.51,308400,960,,,81,19093,17112,35463,15876,2048,87544,True
"Santa Cruz County, California",06,087,2015,269278,94802,135564,133714,37.0,67256,40356.0,17045.0,4860.0,4247.0,131321,10866,142187,2.72,578800,1441,,,324,54688,73685,106388,34517,7146,269278,True
"Trinity County, California",06,105,2015,13373,5484,6495,6878,50.3,34974,1545.0,427.0,46.0,43.0,4832,479,5311,2.38,263100,786,,,10,2318,1944,5996,3115,105,13373,True
"Los Angeles County, California",06,037,2015,10038388,3263069,5093037,4945351,35.6,56196,1316803.0,458481.0,153427.0,85223.0,4635465,515124,5150589,3.02,441900,1231,,,3495,2322174,2609276,3917179,1189759,20621,10038388,True
"Riverside County, California",06,065,2015,2298032,699232,1154555,1143477,34.5,56603,192721.0,76987.0,19411.0,12654.0,920603,136070,1056673,3.24,253200,1179,,,1341,614733,548555,840531,294213,14866,2298032,True
"San Bernardino County, California",06,071,2015,2094769,614325,1052716,1042053,32.5,53433,156673.0,61936.0,14310.0,9298.0,829145,119583,948728,3.33,236700,1116,,,602,579758,538770,767313,208928,5037,2094769,True
"Santa Clara County, California",06,085,2015,1868149,621463,929145,939004,36.8,96310,330869.0,199599.0,34134.0,43627.0,915619,76126,991745,2.95,698600,1705,,,1237,435435,446870,762981,222863,4974,1868149,True
"Marin County, California",06,041,2015,258349,103670,131889,126460,45.4,93257,59435.0,28280.0,11733.0,6055.0,129027,7854,136881,2.41,815100,1678,,,380,53142,39964,116688,48555,704,258349,True
"Placer County, California",06,061,2015,366280,135456,187551,178729,41.0,73948,61722.0,20529.0,6405.0,3225.0,162616,14762,177378,2.67,358500,1303,,,513,85308,69592,148376,63004,892,366280,True
"Siskiyou County, California",06,093,2015,43895,19133,22070,21825,47.8,37170,4922.0,1648.0,429.0,225.0,16127,2337,18464,2.26,174700,806,,,65,8922,7465,17858,9650,1494,43895,True
"Shasta County, California",06,089,2015,178942,69375,91091,87851,42.2,44620,15910.0,5349.0,2181.0,954.0,69261,7965,77226,2.54,216600,926,,,67,38961,36861,69625,33495,1530,178942,True
"Solano County, California",06,095,2015,425753,143612,213872,211881,37.3,66828,50060.0,13776.0,4601.0,2557.0,187021,24000,211021,2.89,279100,1294,,,586,99163,101343,170209,55038,2470,425753,True
"Del Norte County, California",06,015,2015,27788,9420,12370,15418,38.8,40847,1831.0,660.0,198.0,265.0,8612,1116,9728,2.55,183700,808,,,0,5897,6367,11404,4120,347,27788,True
"Glenn County, California",06,021,2015,28029,9497,13861,14168,37.2,39349,1904.0,461.0,204.0,90.0,10523,1518,12041,2.92,204400,725,,,26,7590,5946,10506,3987,2007,28029,True
"Butte County, California",06,007,2015,222564,85318,112449,110115,36.8,43444,25062.0,7667.0,2763.0,1516.0,89411,12264,101675,2.55,221700,905,,,213,45422,61075,79248,36819,3214,222564,True
"Plumas County, California",06,063,2015,18966,8217,9358,9608,51.3,47333,1929.0,852.0,278.0,118.0,7200,1289,8489,2.26,217200,836,,,0,3227,2970,8155,4614,628,18966,True
"San Luis Obispo County, California",06,079,2015,276517,103576,135564,140953,39.3,60691,38026.0,14550.0,4339.0,3332.0,124997,8764,133761,2.51,445700,1235,,,401,50846,75284,103763,46624,3862,276517,True
"Kern County, California",06,029,2015,865736,259700,421189,444547,31.1,49026,52776.0,18062.0,5179.0,3038.0,327294,47438,374732,3.21,167400,888,,,603,255909,225310,301166,83351,38720,865736,True
"Ventura County, California",06,111,2015,840833,268969,424349,416484,37.1,77348,110073.0,44636.0,12327.0,7647.0,398116,37593,435709,3.08,458100,1507,,,523,206217,192754,331778,110084,20912,840833,True
"Calaveras County, California",06,009,2015,44767,18060,22624,22143,50.7,53233,4847.0,1639.0,402.0,130.0,16248,2227,18475,2.45,243800,1038,,,19,8190,6534,19176,10867,362,44767,True
"San Mateo County, California",06,081,2015,748731,259711,380315,368416,39.5,93623,143912.0,62487.0,20113.0,15389.0,387006,27732,414738,2.85,776300,1728,,,405,162030,161771,317566,107364,2195,748731,True
"Tuolumne County, California",06,109,2015,54079,22133,25861,28218,48.6,50306,5611.0,1899.0,538.0,300.0,19477,2878,22355,2.28,259300,917,,,78,9089,10385,22314,12291,471,54079,True
"Amador County, California",06,005,2015,36995,13925,16983,20012,50.0,54171,4204.0,1186.0,504.0,201.0,12573,2048,14621,2.36,251000,1047,,,38,5737,5997,16604,8657,125,36995,True
"Lake County, California",06,033,2015,64158,26993,32012,32146,45.5,35578,4988.0,1659.0,422.0,291.0,23011,3949,26960,2.34,164300,891,,,72,13120,11713,26642,12683,1500,64158,True
"Modoc County, California",06,049,2015,9184,3745,4520,4664,47.8,37860,890.0,208.0,74.0,39.0,3334,315,3649,2.32,153100,653,,,0,1884,1436,3796,2068,638,9184,True
"Inyo County, California",06,027,2015,18373,7957,9159,9214,45.7,45955,1942.0,923.0,179.0,113.0,8370,608,8978,2.23,240100,844,,,22,3827,3301,7396,3849,290,18373,True
"Santa Barbara County, California",06,083,2015,435850,142713,217367,218483,33.6,63985,51447.0,21555.0,7195.0,6027.0,203616,17816,221432,2.92,465300,1369,,,284,98487,126814,150993,59556,16501,435850,True
"Imperial County, California",06,025,2015,178206,46452,87039,91167,32.2,41079,10599.0,3686.0,696.0,121.0,58391,12307,70698,3.61,151600,766,,,26,51022,44695,61773,20716,5630,178206,True
"Alameda County, California",06,001,2015,1584983,558907,808284,776699,37.1,75619,272700.0,134717.0,30924.0,30802.0,778132,70100,848232,2.78,543100,1367,,,1088,343309,397945,651796,191933,2676,1584983,True
"Napa County, California",06,055,2015,140295,49494,70497,69798,40.3,71379,20811.0,6600.0,2508.0,1401.0,68587,5581,74168,2.74,466800,1405,,,243,31100,29915,56197,23083,4241,140295,True
"San Francisco County, California",06,075,2015,840763,353287,412854,427909,38.5,81294,215189.0,92048.0,31357.0,16567.0,478373,34785,513158,2.32,799600,1558,,,569,112704,255814,353068,119177,834,840763,True
"Colusa County, California",06,011,2015,21396,6966,10267,11129,34.0,52168,1519.0,184.0,193.0,47.0,8837,1023,9860,3.04,196000,869,,,41,6051,4879,7735,2731,2408,21396,True
"Kings County, California",06,031,2015,150998,41554,67040,83958,31.4,46481,8941.0,2157.0,1036.0,204.0,50960,7602,58562,3.19,169500,881,,,204,41626,42330,53824,13218,7754,150998,True
"Fresno County, California",06,019,2015,956749,296305,479433,477316,31.4,45233,74082.0,23344.0,8874.0,4546.0,374564,57137,431701,3.17,194600,886,,,1009,277818,247820,326996,104115,38291,956749,True
"Orange County, California",06,059,2015,3116069,1009353,1576469,1539600,37.1,76509,506749.0,187565.0,57152.0,32667.0,1508753,124773,1633526,3.04,553600,1548,,,1151,725250,748213,1244949,397657,6546,3116069,True
"Sutter County, California",06,101,2015,95247,31917,47898,47349,35.4,52017,7354.0,2313.0,816.0,250.0,37520,5691,43211,2.95,198700,906,,,38,25300,21820,34742,13385,3199,95247,True
"San Joaquin County, California",06,077,2015,708554,219073,356154,352400,33.5,53274,54524.0,17034.0,5302.0,3161.0,280460,44592,325052,3.16,223000,1024,,,657,199312,168811,259719,80712,13638,708554,True
"San Diego County, California",06,073,2016,3253356,1103128,1618219,1635137,35.3,66529,487026.0,199234.0,58066.0,44596.0,1495776,126990,1622766,2.87,454600,1395,,,5276,727664,886823,1225434,413435,13032,3253356,True
"Tulare County, California",06,107,2016,455769,134153,227806,227963,30.4,42789,24659.0,8033.0,2901.0,1220.0,171147,20254,191401,3.36,169600,847,,,465,143945,112507,151825,47492,32839,455769,True
"Yolo County, California",06,113,2016,209671,72544,107403,102268,30.9,57663,25078.0,12765.0,4541.0,6541.0,93852,8105,101957,2.78,346200,1147,,,587,45453,70268,70169,23781,3802,209671,True
"Humboldt County, California",06,023,2016,135182,53689,67733,67449,37.6,42685,17031.0,5389.0,1872.0,1366.0,59587,6228,65815,2.44,279000,899,,,110,26399,36407,51623,20753,2307,135182,True
"Nevada County, California",06,057,2016,98639,40587,49806,48833,49.5,57429,16694.0,6092.0,1966.0,818.0,41251,3968,45219,2.4,355900,1205,,,175,17548,16351,41647,23093,425,98639,True
"Alpine County, California",06,003,2016,1184,343,492,692,42.8,62375,140.0,67.0,8.0,20.0,413,55,468,3.34,329500,1109,,,0,274,226,438,246,8,1184,True
"Madera County, California",06,039,2016,153366,43574,79331,74035,33.5,45742,8636.0,2558.0,784.0,518.0,54488,4872,59360,3.34,204800,963,,,184,42662,36762,54231,19711,9887,153366,True
"Mendocino County, California",06,045,2016,87409,34594,43775,43634,42.3,43510,9665.0,3374.0,1139.0,669.0,36803,4526,41329,2.46,319100,975,,,72,19043,16896,34928,16542,2290,87409,True
"Santa Cruz County, California",06,087,2016,270931,95062,136564,134367,37.0,70088,40953.0,18085.0,4872.0,4476.0,132206,10361,142567,2.72,615200,1482,,,471,54522,73929,105856,36624,7079,270931,True
"Trinity County, California",06,105,2016,13180,5468,6428,6752,50.6,35270,1594.0,339.0,72.0,39.0,4791,526,5317,2.35,270100,750,,,12,2277,1816,5906,3181,116,13180,True
"Los Angeles County, California",06,037,2016,10057155,3281845,5102539,4954616,35.8,57952,1348250.0,474729.0,155849.0,86083.0,4709319,460565,5169884,3.01,465000,1264,,,4954,2296785,2612640,3920528,1227202,19679,10057155,True
"Riverside County, California",06,065,2016,2323892,705716,1167766,1156126,34.8,57972,198192.0,79849.0,20311.0,12893.0,946798,120960,1067758,3.25,276300,1212,,,2299,613547,555284,848569,306492,14490,2323892,True
"San Bernardino County, California",06,071,2016,2106754,618922,1058829,1047925,32.7,54469,162213.0,63738.0,14542.0,9429.0,847144,104472,951616,3.32,256000,1144,,,857,576482,542638,769429,218205,5042,2106754,True
"Santa Clara County, California",06,085,2016,1885056,626579,935833,949223,36.8,101173,342701.0,208794.0,34369.0,44998.0,938545,65981,1004526,2.95,752400,1813,,,1493,435218,455223,764341,230274,5141,1885056,True
"Marin County, California",06,041,2016,259358,104400,132613,126745,45.7,100310,61100.0,28898.0,12285.0,6010.0,130366,7021,137387,2.41,859400,1764,,,421,53207,39968,115707,50476,700,259358,True
"Placer County, California",06,061,2016,370571,136730,189781,180790,41.5,76926,63509.0,21583.0,6611.0,2986.0,166417,12582,178999,2.68,380900,1339,,,678,85141,69806,149445,66179,923,370571,True
"Siskiyou County, California",06,093,2016,43668,19045,21955,21713,47.9,38524,4715.0,1640.0,491.0,183.0,16240,2161,18401,2.26,173100,828,,,66,8841,7554,17332,9941,1518,43668,True
"Shasta County, California",06,089,2016,179228,69713,91325,87903,42.3,45582,16539.0,5537.0,2228.0,857.0,70876,6728,77604,2.53,223500,945,,,92,38822,36984,68852,34570,1598,179228,True
"Solano County, California",06,095,2016,429596,145315,216078,213518,37.5,69227,50923.0,14765.0,4536.0,2445.0,191173,21347,212520,2.88,305900,1337,,,826,98840,102287,170194,58275,2607,429596,True
"Del Norte County, California",06,015,2016,27628,9443,12460,15168,38.1,42363,1688.0,678.0,311.0,214.0,8922,1041,9963,2.55,183600,818,,,0,5855,6461,11090,4222,452,27628,True
"Glenn County, California",06,021,2016,27976,9801,13760,14216,36.9,41699,1703.0,357.0,147.0,62.0,10629,1172,11801,2.82,215800,750,,,27,7572,5916,10415,4073,2270,27976,True
"Butte County, California",06,007,2016,223877,85505,112951,110926,36.9,44366,25225.0,8002.0,2915.0,1611.0,91019,10933,101952,2.55,228500,936,,,366,45472,61391,78869,38145,3597,223877,True
"Plumas County, California",06,063,2016,18754,8376,9270,9484,51.7,50125,1828.0,988.0,271.0,94.0,7320,977,8297,2.19,221300,846,,,12,3108,2940,8033,4673,667,18754,True
"San Luis Obispo County, California",06,079,2016,278680,104404,137108,141572,39.0,64014,39994.0,15020.0,4296.0,3476.0,128359,7479,135838,2.51,471800,1257,,,477,50812,75701,103243,48924,3679,278680,True
"Kern County, California",06,029,2016,871337,262337,424258,447079,31.2,49788,54412.0,18553.0,5182.0,3122.0,330594,44848,375442,3.2,175600,905,,,939,256757,226832,301706,86042,40250,871337,True
"Ventura County, California",06,111,2016,843110,269338,425668,417442,37.3,78593,111571.0,45763.0,12888.0,8589.0,403177,32651,435828,3.09,481400,1572,,,591,204168,193120,331202,114620,21785,843110,True
"Calaveras County, California",06,009,2016,44787,17713,22631,22156,51.2,53502,4645.0,1550.0,424.0,226.0,16565,1758,18323,2.5,259000,1120,,,46,8042,6671,18829,11245,296,44787,True
"San Mateo County, California",06,081,2016,754748,261010,383203,371545,39.5,98546,148547.0,66121.0,20918.0,16375.0,395999,23439,419438,2.85,845300,1830,,,604,162440,164010,317779,110519,1948,754748,True
"Tuolumne County, California",06,109,2016,53864,22083,25730,28134,48.2,50731,5312.0,1929.0,538.0,255.0,19597,2570,22167,2.29,259800,936,,,76,8983,10408,21845,12628,455,53864,True
"Amador County, California",06,005,2016,36963,14248,17124,19839,50.3,57032,4212.0,1192.0,540.0,240.0,12835,1677,14512,2.31,265900,1061,,,70,5745,5948,16128,9142,296,36963,True
"Lake County, California",06,033,2016,64076,26194,32094,31982,45.8,36132,4821.0,1810.0,528.0,309.0,22432,3554,25986,2.41,167300,882,,,109,13028,11804,26122,13122,1437,64076,True
"Modoc County, California",06,049,2016,9033,3670,4396,4637,47.1,41194,926.0,208.0,61.0,26.0,3531,259,3790,2.32,144600,681,,,0,1812,1484,3649,2088,635,9033,True
"Inyo County, California",06,027,2016,18326,7973,9091,9235,45.4,47278,1991.0,973.0,129.0,148.0,8307,555,8862,2.22,235500,829,,,30,3772,3352,7249,3953,344,18326,True
"Santa Barbara County, California",06,083,2016,439395,143051,219236,220159,33.7,65161,51832.0,22062.0,7146.0,6101.0,206094,16101,222195,2.93,480000,1423,,,406,98870,128178,150830,61517,16979,439395,True
"Imperial County, California",06,025,2016,178807,45800,87483,91324,32.2,42560,10576.0,3627.0,680.0,146.0,58456,12048,70504,3.68,159000,778,,,73,51341,44844,61311,21311,5333,178807,True
"Alameda County, California",06,001,2016,1605217,564293,818487,786730,37.2,79831,282754.0,141689.0,32639.0,31512.0,801026,61327,862353,2.79,593500,1432,,,1280,344212,404549,656757,199699,2659,1605217,True
"Napa County, California",06,055,2016,140823,49375,70813,70010,40.7,74609,21345.0,6815.0,2523.0,1452.0,69893,4910,74803,2.76,503100,1442,,,283,30852,29929,56093,23949,4480,140823,True
"San Francisco County, California",06,075,2016,850282,356797,417056,433226,38.4,87701,220335.0,95666.0,32831.0,17732.0,488560,32234,520794,2.33,858800,1632,,,755,114628,259353,354006,122295,918,850282,True
"Colusa County, California",06,011,2016,21361,6962,10264,11097,34.7,54946,1474.0,233.0,195.0,30.0,9161,871,10032,3.04,205000,896,,,47,5936,4827,7818,2780,2719,21361,True
"Kings County, California",06,031,2016,150261,41845,67054,83207,31.4,47241,8378.0,2128.0,969.0,268.0,52048,6890,58938,3.18,172000,889,,,282,41331,42114,53185,13631,7820,150261,True
"Fresno County, California",06,019,2016,963160,299456,482633,480527,31.6,45963,76303.0,24116.0,8969.0,4887.0,380621,51478,432099,3.16,204900,901,,,1480,278246,248640,328349,107925,37732,963160,True
"Orange County, California",06,059,2016,3132211,1017012,1585524,1546687,37.3,78145,520755.0,195472.0,58548.0,32797.0,1532549,111106,1643655,3.04,584200,1608,,,1890,721172,750571,1247767,412701,6857,3132211,True
"Sutter County, California",06,101,2016,95406,32028,47920,47486,35.6,52943,7623.0,2310.0,766.0,269.0,38409,4836,43245,2.95,213100,941,,,96,25180,21761,34670,13795,3491,95406,True
"San Joaquin County, California",06,077,2016,714860,221707,359141,355719,33.7,55045,55004.0,16993.0,5472.0,2828.0,287650,38954,326604,3.16,246900,1057,,,1039,199521,170038,261385,83916,13744,714860,True
"Merced County, California",06,047,2016,265001,78270,131219,133782,30.6,44397,13682.0,4956.0,1238.0,1165.0,97146,18143,115289,3.31,171800,882,,,188,79805,68449,89011,27736,12820,265001,True
"Mariposa County, California",06,043,2016,17645,7255,8764,8881,50.6,49265,1879.0,839.0,210.0,137.0,7167,780,7947,2.29,250800,820,,,24,2918,2935,7411,4381,266,17645,True
"Yuba County, California",06,115,2016,73897,25655,36426,37471,32.2,48739,4885.0,1693.0,432.0,99.0,26389,3822,30211,2.83,190700,918,,,140,20606,18977,25851,8463,1349,73897,True
"Contra Costa County, California",06,013,2016,1107925,387540,567254,540671,39.1,82881,192616.0,73252.0,22496.0,14818.0,521577,43374,564951,2.83,472900,1506,,,1618,260665,233070,456827,157363,2639,1107925,True
"Lassen County, California",06,035,2016,31945,9501,10754,21191,36.4,51457,1749.0,728.0,281.0,103.0,9044,942,9986,2.31,174500,919,,,34,5262,10079,12682,3922,577,31945,True
"Stanislaus County, California",06,099,2016,530561,170328,268410,262151,33.8,51591,36783.0,11983.0,4428.0,1544.0,212544,33913,246457,3.08,216000,1005,,,388,145560,128046,192512,64443,11289,530561,True
"Sonoma County, California",06,097,2016,497776,189043,253857,243919,41.2,66833,74393.0,26826.0,10000.0,4723.0,243985,18297,262282,2.59,464700,1380,,,709,102675,109048,202709,83344,7501,497776,True
"Tehama County, California",06,103,2016,63015,23573,31636,31379,40.6,40687,3939.0,1353.0,441.0,179.0,23094,3340,26434,2.64,178600,781,,,78,15159,12318,24262,11276,1344,63015,True
"Mono County, California",06,051,2016,14051,4950,6500,7551,38.9,58937,2063.0,539.0,224.0,20.0,7642,665,8307,2.77,286100,1107,,,9,2783,3642,5770,1856,429,14051,True
"San Benito County, California",06,069,2016,58051,17390,28989,29062,35.1,73814,4777.0,1439.0,500.0,233.0,26637,3211,29848,3.32,423100,1316,,,72,15708,13264,22560,6519,1861,58051,True
"Sacramento County, California",06,067,2016,1479300,527335,756345,722955,35.7,57509,189759.0,64859.0,22097.0,9868.0,648876,74025,722901,2.76,271300,1065,,,966,360897,363713,565426,189264,5257,1479300,True
"El Dorado County, California",06,017,2016,183000,67528,91651,91349,45.2,72586,27316.0,10371.0,3390.0,1900.0,80240,8506,88746,2.68,379200,1105,,,469,38406,32126,79757,32711,834,183000,True
"Monterey County, California",06,053,2016,430201,125916,210318,219883,33.7,60889,38978.0,16843.0,4788.0,3361.0,180631,13288,193919,3.27,393300,1275,,,351,113889,109483,155276,51553,32242,430201,True
"Sierra County, California",06,091,2016,2931,1275,1482,1449,55.2,43984,352.0,82.0,20.0,17.0,1225,50,1275,2.27,170300,961,,,0,425,317,1425,764,67,2931,True
"Merced County, California",06,047,2017,267390,79261,132345,135045,30.8,46338,14006.0,5063.0,1337.0,1135.0,99026,16969,115995,3.3,196200,934,16103.0,60330.0,349,79864,69132,89783,28611,12351,267390,True
"Lake County, California",06,033,2017,64095,26327,32307,31788,45.8,40446,4588.0,1678.0,577.0,273.0,22691,2872,25563,2.4,182000,914,6790.0,18839.0,136,13128,11618,25788,13561,1497,64095,True
"Mariposa County, California",06,043,2017,17658,7434,8795,8863,51.1,51385,2017.0,933.0,253.0,132.0,7009,777,7786,2.23,259500,869,1707.0,5446.0,41,2902,2945,7213,4598,252,17658,True
"Modoc County, California",06,049,2017,9017,3638,4358,4659,47.8,39296,859.0,227.0,50.0,0.0,3231,263,3494,2.34,143100,739,1066.0,2507.0,0,1758,1453,3592,2214,517,9017,True
"Yuba County, California",06,115,2017,74644,25880,36563,38081,32.4,51776,5573.0,1565.0,406.0,84.0,27832,3057,30889,2.83,207100,923,4268.0,20851.0,188,20665,19131,26161,8687,1215,74644,True
"Contra Costa County, California",06,013,2017,1123678,389597,575003,548675,39.2,88456,198521.0,76942.0,22425.0,14617.0,535401,39750,575151,2.86,522300,1600,36008.0,345194.0,2507,261503,236836,461568,163771,2382,1123678,True
"Inyo County, California",06,027,2017,18195,8026,9023,9172,45.6,51500,2103.0,915.0,160.0,166.0,8275,450,8725,2.19,243100,875,1421.0,6105.0,44,3708,3310,7218,3959,418,18195,True
"Lassen County, California",06,035,2017,31470,9441,10684,20786,36.2,54083,1761.0,652.0,248.0,120.0,9052,729,9781,2.28,177500,942,2143.0,7034.0,34,5025,10181,12263,4001,634,31470,True
"Stanislaus County, California",06,099,2017,535684,171324,270860,264824,33.9,54260,38138.0,11704.0,4612.0,1748.0,219505,29240,248745,3.1,244100,1049,30506.0,136694.0,635,146335,129347,194158,65844,11912,535684,True
"Santa Barbara County, California",06,083,2017,442996,144015,221041,221955,33.7,68023,54031.0,23123.0,7370.0,6240.0,211793,14894,226687,2.94,509400,1496,20048.0,119659.0,471,99286,129718,150782,63210,17561,442996,True
"Sonoma County, California",06,097,2017,500943,190058,255562,245381,41.4,71769,77016.0,28192.0,9981.0,5073.0,249134,15700,264834,2.59,513300,1456,20913.0,163013.0,798,101946,109136,202722,87139,7023,500943,True
"Tehama County, California",06,103,2017,63247,23712,31795,31452,41.1,42512,4202.0,1350.0,521.0,122.0,23849,2692,26541,2.63,191400,812,6067.0,16907.0,95,15127,12328,24084,11708,1272,63247,True
"Imperial County, California",06,025,2017,179957,45198,87994,91963,32.2,44779,10692.0,3877.0,742.0,187.0,59757,11415,71172,3.77,167700,805,11776.0,31824.0,109,51734,45316,61091,21816,5335,179957,True
"Mono County, California",06,051,2017,14058,4899,6625,7433,38.3,60595,2250.0,614.0,164.0,29.0,7864,290,8154,2.8,311700,1103,1021.0,3674.0,4,2738,3740,5659,1921,542,14058,True
"San Benito County, California",06,069,2017,58671,17440,29463,29208,35.4,80760,4980.0,1476.0,453.0,261.0,27688,2686,30374,3.35,459700,1369,1779.0,15279.0,130,15629,13387,22765,6890,1721,58671,True
"Alameda County, California",06,001,2017,1629615,569070,829966,799649,37.3,85743,293137.0,149371.0,34121.0,32665.0,826310,53175,879485,2.81,649100,1547,63741.0,490044.0,1579,344912,411001,665009,208693,2764,1629615,True
"Sacramento County, California",06,067,2017,1495400,532050,764720,730680,35.9,60239,196514.0,67958.0,22412.0,10702.0,666790,64575,731365,2.76,299900,1122,70408.0,443314.0,1243,361889,367148,571634,194729,5196,1495400,True
"El Dorado County, California",06,017,2017,185015,68084,92711,92304,45.5,74885,28348.0,10599.0,3416.0,1885.0,80373,7042,87415,2.69,405900,1122,8418.0,57510.0,687,38163,32432,79470,34950,867,185015,True
"Napa County, California",06,055,2017,141005,49044,70694,70311,40.8,79637,22344.0,7116.0,2977.0,1418.0,71110,4068,75178,2.79,560500,1541,5533.0,42419.0,377,30346,30074,56064,24521,3842,141005,True
"Monterey County, California",06,053,2017,433168,125939,212152,221016,33.9,63249,39587.0,17199.0,5241.0,3414.0,182439,11717,194156,3.3,441000,1338,23046.0,99361.0,525,114309,109118,155996,53745,32213,433168,True
"San Francisco County, California",06,075,2017,864263,358772,423630,440633,38.3,96265,228294.0,100265.0,33789.0,18718.0,504914,29102,534016,2.35,927400,1709,44729.0,304567.0,816,115952,263969,355958,128384,1013,864263,True
"Sierra County, California",06,091,2017,2885,1208,1397,1488,55.0,44190,344.0,114.0,20.0,17.0,1149,64,1213,2.36,157100,919,352.0,837.0,0,426,333,1363,763,53,2885,True
"Tulare County, California",06,107,2017,458809,135144,229321,229488,30.6,44871,24752.0,8504.0,2505.0,1130.0,173820,19405,193225,3.35,180200,877,34783.0,95074.0,609,143843,112977,153077,48912,32263,458809,True
"Yolo County, California",06,113,2017,212605,72845,108988,103617,30.9,61621,25761.0,13161.0,4996.0,6487.0,95944,7489,103433,2.81,370800,1204,9068.0,61256.0,710,45711,71555,70862,24477,4234,212605,True
"Humboldt County, California",06,023,2017,135490,53966,67982,67508,37.7,43718,17668.0,5838.0,2115.0,1263.0,59592,5850,65442,2.43,285800,914,8712.0,43188.0,134,26358,36145,51236,21751,2455,135490,True
"Nevada County, California",06,057,2017,98838,40386,50106,48732,49.8,60610,17134.0,6643.0,2156.0,941.0,42302,3348,45650,2.42,379800,1217,5316.0,33789.0,254,17372,16180,41160,24126,456,98838,True
"Alpine County, California",06,003,2017,1203,304,539,664,44.9,63438,121.0,57.0,10.0,20.0,374,64,438,3.84,343800,1083,27.0,266.0,0,258,231,383,331,13,1203,True
"Madera County, California",06,039,2017,154440,44458,79857,74583,33.7,48210,8945.0,2836.0,913.0,602.0,56076,5045,61121,3.29,220400,980,10542.0,32401.0,256,42747,36848,54654,20191,9697,154440,True
"Mendocino County, California",06,045,2017,87497,34182,43829,43668,42.4,46528,10117.0,3237.0,1179.0,752.0,37084,4304,41388,2.5,338000,1048,7078.0,25894.0,99,19038,16875,34363,17221,2352,87497,True
"Santa Cruz County, California",06,087,2017,273263,95536,137609,135654,37.3,73663,41971.0,18611.0,5156.0,4869.0,133847,9672,143519,2.73,659900,1552,11331.0,81697.0,587,54347,74647,105384,38885,6805,273263,True
"Trinity County, California",06,105,2017,13037,5462,6434,6603,51.4,36563,1556.0,306.0,52.0,52.0,4800,507,5307,2.33,286500,803,1719.0,3589.0,4,2163,1845,5699,3330,153,13037,True
"Los Angeles County, California",06,037,2017,10105722,3295198,5126081,4979641,36.0,61015,1384333.0,492924.0,158811.0,88238.0,4805817,406426,5212243,3.01,495800,1322,538359.0,2649480.0,6436,2273580,2624186,3942972,1264984,19759,10105722,True
"Riverside County, California",06,065,2017,2355002,711724,1183291,1171711,35.0,60807,205329.0,83333.0,21150.0,13123.0,978726,107383,1086109,3.26,304500,1251,101093.0,592038.0,3086,613721,562903,861399,316979,14368,2355002,True
"San Bernardino County, California",06,071,2017,2121220,623642,1066050,1055170,32.9,57156,168511.0,66158.0,15271.0,9730.0,869658,95079,964737,3.31,280200,1182,96801.0,497411.0,1343,573723,547049,775274,225174,4846,2121220,True
"Santa Clara County, California",06,085,2017,1911226,630451,947909,963317,37.0,106761,351778.0,220693.0,35568.0,47562.0,967294,58215,1025509,2.98,829600,1955,50251.0,566263.0,2160,435016,464054,772191,239965,5394,1911226,True
"Marin County, California",06,041,2017,260814,104846,133391,127423,46.1,104703,62021.0,29375.0,12594.0,5886.0,130570,6211,136781,2.42,908800,1863,8607.0,93586.0,508,53113,39842,114894,52965,680,260814,True
"Placer County, California",06,061,2017,374985,138564,191964,183021,41.6,80488,65212.0,22438.0,7136.0,2985.0,170791,10216,181007,2.68,413300,1398,13561.0,121423.0,816,85279,70365,151097,68244,1141,374985,True
"Siskiyou County, California",06,093,2017,43530,19018,21824,21706,47.9,40884,4777.0,1720.0,524.0,183.0,16544,1655,18199,2.26,176600,829,4052.0,14458.0,98,8815,7371,17164,10180,1765,43530,True
"Shasta County, California",06,089,2017,178919,70486,91166,87753,41.8,47258,17495.0,6099.0,2400.0,721.0,72195,5246,77441,2.49,233500,966,14166.0,53685.0,164,38767,37110,68314,34728,1526,178919,True
"Solano County, California",06,095,2017,434981,147352,218907,216074,37.7,72950,52721.0,15710.0,4602.0,2444.0,196309,18266,214575,2.88,342000,1407,16093.0,127539.0,1267,98898,103249,171280,61554,2583,434981,True
"Del Norte County, California",06,015,2017,27442,9683,12434,15008,38.7,41287,1695.0,666.0,298.0,145.0,8742,916,9658,2.5,185900,826,1930.0,7129.0,0,5827,6188,11070,4357,449,27442,True
"Colusa County, California",06,011,2017,21479,7047,10322,11157,34.7,56481,1524.0,338.0,226.0,36.0,9470,592,10062,3.02,223600,896,1553.0,5316.0,72,5964,4870,7773,2872,2655,21479,True
"Glenn County, California",06,021,2017,27935,9936,13722,14213,36.8,46260,1819.0,291.0,150.0,68.0,10775,1096,11871,2.78,214600,775,3036.0,6441.0,34,7508,5917,10339,4171,2502,27935,True
"Butte County, California",06,007,2017,225207,86167,113620,111587,36.9,46516,25811.0,8343.0,3253.0,1440.0,93439,9329,102768,2.54,238200,970,12974.0,70498.0,427,45454,61853,78951,38949,3668,225207,True
"Kings County, California",06,031,2017,150183,42349,67201,82982,31.5,49742,8518.0,2203.0,1018.0,252.0,53158,5683,58841,3.18,185600,918,9351.0,31492.0,462,41163,42033,52772,14215,8101,150183,True
"Plumas County, California",06,063,2017,18724,8287,9292,9432,52.1,50266,1806.0,1114.0,271.0,80.0,7260,752,8012,2.21,228900,840,1988.0,5981.0,5,3066,2830,8004,4824,556,18724,True
"San Luis Obispo County, California",06,079,2017,280119,105044,137937,142182,39.0,67175,39299.0,15447.0,4622.0,3809.0,129277,6586,135863,2.51,499800,1326,11976.0,90169.0,584,50766,75977,102714,50662,3858,280119,True
"Fresno County, California",06,019,2017,971616,301824,486949,484667,31.8,48730,78378.0,25209.0,9767.0,5035.0,392003,45315,437318,3.16,220600,931,62139.0,228210.0,2684,279215,250075,331458,110868,36920,971616,True
"Kern County, California",06,029,2017,878744,264993,428351,450393,31.3,50826,55523.0,19285.0,5010.0,3263.0,335688,41082,376770,3.2,190600,933,57607.0,197738.0,1310,257652,228411,303454,89227,42158,878744,True
"Orange County, California",06,059,2017,3155816,1024976,1597571,1558245,37.5,81851,537600.0,202104.0,60031.0,33381.0,1560997,96039,1657036,3.04,620500,1693,97075.0,904714.0,2663,716767,755511,1257093,426445,7219,3155816,True
"Ventura County, California",06,111,2017,847834,270046,428298,419536,37.5,81972,114671.0,46109.0,13277.0,9202.0,410179,28752,438931,3.09,520300,1643,34244.0,230689.0,760,202341,194425,331822,119246,22705,847834,True
"Calaveras County, California",06,009,2017,45057,17812,22765,22292,51.6,54800,4306.0,1705.0,383.0,210.0,16721,1281,18002,2.5,273400,1195,3454.0,13820.0,63,7945,6847,18680,11585,392,45057,True
"Sutter County, California",06,101,2017,95583,32188,47970,47613,35.7,54347,7398.0,2344.0,817.0,258.0,38207,4491,42698,2.94,234500,980,5689.0,25545.0,207,25120,21707,34799,13957,3800,95583,True
"San Mateo County, California",06,081,2017,763450,261796,387305,376145,39.6,105667,153522.0,71057.0,21924.0,17695.0,404882,20174,425056,2.88,917700,1973,24383.0,232316.0,831,162234,167053,319099,115064,2001,763450,True
"Tuolumne County, California",06,109,2017,53899,22267,25870,28029,48.6,54325,5362.0,2045.0,717.0,296.0,20401,1750,22151,2.27,273500,961,4382.0,17158.0,77,9047,10293,21585,12974,570,53899,True
"San Joaquin County, California",06,077,2017,724153,223808,363906,360247,33.9,57813,55477.0,17720.0,5374.0,2932.0,296264,33271,329535,3.17,281100,1100,42061.0,175226.0,1378,200364,172147,265104,86538,13743,724153,True
"Amador County, California",06,005,2017,37306,14185,17301,20005,50.6,60636,4285.0,1240.0,584.0,289.0,13444,1371,14815,2.37,278600,1056,2368.0,11364.0,66,5731,6058,15952,9565,324,37306,True
"San Diego County, California",06,073,2017,3283665,1111739,1632518,1651147,35.4,70588,505483.0,209580.0,60233.0,45618.0,1536073,116758,1652831,2.87,484900,1467,118026.0,970352.0,7612,728462,892901,1237085,425217,12476,3283665,True
"Lake County, California",06,033,2018,64148,25966,32269,31879,45.6,42475,4759.0,1654.0,628.0,283.0,23589,2556,26145,2.43,195400,968,6266.0,19016.0,173,13290,11437,25480,13941,1601,64148,True
"Merced County, California",06,047,2018,269075,79606,133259,135816,30.9,50129,14395.0,5369.0,1267.0,1020.0,102638,14912,117550,3.31,229500,973,13518.0,63910.0,530,80062,69488,90205,29320,12709,269075,True
"Mariposa County, California",06,043,2018,17540,7700,8620,8920,51.4,51199,1997.0,842.0,238.0,120.0,7051,676,7727,2.13,269500,799,1397.0,6024.0,32,2865,2901,7084,4690,236,17540,True
"Modoc County, California",06,049,2018,8938,3660,4325,4613,47.7,45149,706.0,307.0,56.0,9.0,3125,274,3399,2.31,133300,705,1022.0,2558.0,0,1733,1547,3365,2293,609,8938,True
"Contra Costa County, California",06,013,2018,1133247,392277,579546,553701,39.4,93712,203101.0,82449.0,23381.0,15406.0,547323,35563,582886,2.86,582400,1702,30633.0,354641.0,3690,261300,238221,463944,169782,2544,1133247,True
"Inyo County, California",06,027,2018,18085,8083,9001,9084,45.7,52874,2127.0,1028.0,153.0,144.0,8090,447,8537,2.16,262400,891,1357.0,6310.0,49,3635,3253,7049,4148,381,18085,True
"Stanislaus County, California",06,099,2018,539301,172682,272457,266844,34.0,57387,39083.0,11898.0,4537.0,2005.0,222532,26130,248662,3.09,272400,1099,25775.0,143603.0,878,146907,129823,194801,67770,11934,539301,True
"Santa Barbara County, California",06,083,2018,443738,144962,221530,222208,33.7,71657,54801.0,23998.0,7254.0,6581.0,211751,13861,225612,2.92,549900,1576,16369.0,124591.0,537,99117,129780,150066,64775,18044,443738,True
"Mono County, California",06,051,2018,14174,4847,6833,7341,38.3,63018,2336.0,597.0,91.0,52.0,8278,262,8540,2.86,326400,1125,626.0,4071.0,6,2689,3707,5748,2030,395,14174,True
"San Benito County, California",06,069,2018,59416,17740,29790,29626,35.5,81977,5164.0,1601.0,467.0,254.0,28831,2294,31125,3.33,496200,1477,1619.0,15818.0,113,15603,13627,22992,7194,1855,59416,True
"Sacramento County, California",06,067,2018,1510023,536029,772281,737742,36.0,63902,203352.0,70481.0,23020.0,11273.0,686019,54551,740570,2.77,330100,1184,60474.0,461023.0,1483,362761,369342,575713,202207,5486,1510023,True
"El Dorado County, California",06,017,2018,186661,69172,93621,93040,45.8,80582,29222.0,10606.0,3615.0,1954.0,83049,5480,88529,2.67,437200,1200,7618.0,59779.0,840,38016,32672,79222,36751,893,186661,True
"Monterey County, California",06,053,2018,433212,126052,212245,220967,34.1,66676,40485.0,17746.0,5495.0,3431.0,185025,10475,195500,3.3,477200,1401,20633.0,102281.0,725,114125,107775,155797,55515,33069,433212,True
"San Francisco County, California",06,075,2018,870044,359673,426074,443970,38.2,104552,236593.0,104369.0,33951.0,19091.0,515382,25320,540702,2.36,1009500,1805,40493.0,310423.0,966,116897,266524,355185,131438,1003,870044,True
"San Diego County, California",06,073,2018,3302833,1118980,1640902,1661931,35.6,74855,521525.0,216698.0,62424.0,47375.0,1564930,106962,1671892,2.87,526300,1569,101881.0,995991.0,10377,726344,894498,1242396,439595,12770,3302833,True
"Tulare County, California",06,107,2018,460477,136106,230222,230255,30.8,47518,25710.0,8869.0,2703.0,1211.0,177236,18321,195557,3.34,191200,904,30880.0,100897.0,753,143528,112819,153739,50391,31558,460477,True
"Humboldt County, California",06,023,2018,135768,54267,68102,67666,38.0,45528,18017.0,5945.0,2176.0,1242.0,60970,5327,66297,2.43,296600,947,8276.0,44253.0,165,26259,35908,50954,22647,2883,135768,True
"Alpine County, California",06,003,2018,1146,299,534,612,44.3,64688,149.0,56.0,11.0,19.0,366,79,445,3.71,349000,540,32.0,254.0,0,239,214,400,293,14,1146,True
"Madera County, California",06,039,2018,155013,44759,80330,74683,33.9,52884,9696.0,2981.0,928.0,479.0,57799,5243,63042,3.28,235200,986,8855.0,34547.0,321,42814,36650,54752,20797,9204,155013,True
"Santa Cruz County, California",06,087,2018,273765,95756,138038,135727,37.4,78041,42317.0,18862.0,5478.0,4953.0,134904,9027,143931,2.73,711000,1647,10412.0,82994.0,642,53761,74696,104307,41001,6819,273765,True
"Trinity County, California",06,105,2018,12862,5796,6280,6582,51.8,38497,1482.0,391.0,47.0,45.0,4758,446,5204,2.17,284600,815,1754.0,3943.0,6,2172,1781,5520,3389,302,12862,True
"Riverside County, California",06,065,2018,2383286,718349,1197098,1186188,35.3,63948,212065.0,86849.0,20794.0,14010.0,1007795,94709,1102504,3.27,330600,1311,90026.0,611462.0,4262,613808,568166,872703,328609,14433,2383286,True
"San Bernardino County, California",06,071,2018,2135413,630633,1072941,1062472,33.1,60164,175216.0,68909.0,16166.0,9737.0,892435,85647,978082,3.3,305400,1230,83818.0,517165.0,2019,572852,550020,779198,233343,4771,2135413,True
"Marin County, California",06,041,2018,260295,105258,133182,127113,46.5,110217,63261.0,30097.0,12688.0,5972.0,131425,5149,136574,2.4,959200,1970,7245.0,95577.0,695,52908,39592,113170,54625,809,260295,True
"Placer County, California",06,061,2018,380077,140661,194566,185511,41.9,84357,68639.0,23038.0,7636.0,3032.0,173493,9005,182498,2.67,443700,1463,12317.0,124949.0,957,85719,70709,152550,71099,1249,380077,True
"Shasta County, California",06,089,2018,179085,70473,91226,87859,41.8,50905,18432.0,6117.0,2675.0,771.0,72392,4824,77216,2.49,242500,1000,12120.0,56019.0,202,38673,37040,67751,35621,1367,179085,True
"Solano County, California",06,095,2018,438530,149067,220599,217931,37.9,77609,54826.0,16665.0,4446.0,2559.0,202713,15346,218059,2.87,377500,1498,13490.0,132604.0,1743,98813,103615,171712,64390,2739,438530,True
"Colusa County, California",06,011,2018,21464,7113,10340,11124,35.1,56704,1571.0,353.0,131.0,48.0,9663,520,10183,2.99,249800,877,1474.0,5530.0,103,5883,4825,7790,2966,2615,21464,True
"Tehama County, California",06,103,2018,63373,24025,31869,31504,40.9,42899,4820.0,1315.0,483.0,91.0,24265,2484,26749,2.6,203400,839,5907.0,17440.0,165,15178,12399,23831,11965,1617,63373,True
"Yuba County, California",06,115,2018,75493,26179,37025,38468,32.5,52624,5531.0,1711.0,472.0,152.0,28954,2648,31602,2.83,231900,951,4248.0,21182.0,320,20874,19348,26196,9075,1215,75493,True
"Lassen County, California",06,035,2018,31185,9493,10514,20671,36.0,56362,1787.0,540.0,276.0,94.0,8788,570,9358,2.23,184200,945,1882.0,7330.0,37,4926,10156,11946,4157,562,31185,True
"Sonoma County, California",06,097,2018,501317,189339,256121,245196,41.7,76753,78692.0,30256.0,10437.0,5488.0,253421,13543,266964,2.6,568700,1549,17953.0,165995.0,940,100818,107948,201454,91097,6885,501317,True
"Imperial County, California",06,025,2018,180216,44057,87966,92250,32.4,45834,10794.0,3883.0,906.0,219.0,59919,10782,70701,3.87,177100,818,9837.0,32790.0,117,51676,45412,60682,22446,5716,180216,True
"Alameda County, California",06,001,2018,1643700,572870,836529,807171,37.4,92574,305740.0,157561.0,34881.0,33519.0,847170,45110,892280,2.81,707800,1674,55710.0,502952.0,1959,344513,414650,668620,215917,2868,1643700,True
"Napa County, California",06,055,2018,140530,49032,70448,70082,41.1,84753,22549.0,7305.0,3011.0,1412.0,70888,3728,74616,2.78,603700,1621,4926.0,43118.0,307,29894,29685,55591,25360,4004,140530,True
"Sierra County, California",06,091,2018,2930,1241,1388,1542,55.5,48125,207.0,191.0,20.0,18.0,1251,60,1311,2.34,173200,888,309.0,913.0,0,441,346,1290,853,46,2930,True
"Yolo County, California",06,113,2018,214977,73510,110602,104375,31.0,65923,26649.0,13780.0,5523.0,6472.0,97374,6722,104096,2.81,395500,1266,7510.0,63886.0,922,45919,72458,71159,25441,3810,214977,True
"Nevada County, California",06,057,2018,99092,40904,50203,48889,50.1,63240,17914.0,6818.0,1934.0,1088.0,43368,2971,46339,2.39,400000,1222,4970.0,34790.0,272,17189,16029,40697,25177,535,99092,True
"Mendocino County, California",06,045,2018,87422,34090,43983,43439,42.8,49233,10087.0,3298.0,1197.0,659.0,37712,3837,41549,2.5,356800,1100,6194.0,26921.0,139,18891,16701,33985,17845,2651,87422,True
"Los Angeles County, California",06,037,2018,10098052,3306109,5121264,4976788,36.2,64251,1416842.0,510104.0,161247.0,89288.0,4869658,357178,5226836,3.0,543400,1390,475645.0,2726485.0,7828,2246521,2615977,3936277,1299277,18979,10098052,True
"Santa Clara County, California",06,085,2018,1922200,635525,951731,970469,37.0,116178,361683.0,231988.0,36454.0,49373.0,985838,49598,1035436,2.97,913000,2126,43893.0,578387.0,2807,432684,470621,771987,246908,4900,1922200,True
"Siskiyou County, California",06,093,2018,43540,19257,21834,21706,48.0,44200,4730.0,1587.0,586.0,260.0,16725,1440,18165,2.23,186300,836,3651.0,15121.0,100,8797,7390,16890,10463,1782,43540,True
"Del Norte County, California",06,015,2018,27424,9799,12849,14575,38.6,45258,1619.0,698.0,317.0,148.0,8823,796,9619,2.48,204000,862,1706.0,7560.0,24,5954,6114,10771,4585,381,27424,True
"Glenn County, California",06,021,2018,27897,10017,13726,14171,36.6,47395,1947.0,291.0,138.0,108.0,10994,806,11800,2.75,222000,788,2611.0,7055.0,68,7470,5950,10177,4300,2582,27897,True
"Butte County, California",06,007,2018,227075,86797,114562,112513,37.1,48443,25926.0,8566.0,3250.0,1518.0,94908,9085,103993,2.55,248100,1016,11702.0,72797.0,505,45658,62220,78978,40219,3683,227075,True
"Kings County, California",06,031,2018,150075,42735,67401,82674,31.7,53865,8784.0,2452.0,916.0,286.0,53217,4855,58072,3.16,202800,971,8128.0,33197.0,492,40935,41878,52695,14567,7726,150075,True
"Plumas County, California",06,063,2018,18699,8047,9276,9423,52.2,53270,1922.0,1136.0,241.0,91.0,7536,516,8052,2.28,234900,868,1634.0,6192.0,31,3063,2920,7728,4988,289,18699,True
"San Luis Obispo County, California",06,079,2018,281455,105317,138686,142769,39.1,70699,40138.0,16224.0,4837.0,3724.0,129358,6175,135533,2.52,537900,1385,11257.0,91361.0,663,50492,76173,102032,52758,3943,281455,True
"Fresno County, California",06,019,2018,978130,304624,490194,487936,32.0,51261,82089.0,26629.0,10077.0,4612.0,400175,41276,441451,3.16,237500,967,55958.0,238774.0,3550,279979,250158,333555,114438,39198,978130,True
"Kern County, California",06,029,2018,883053,267913,430407,452646,31.5,52479,57030.0,20614.0,5098.0,3010.0,339384,39056,378440,3.18,205200,956,51810.0,206956.0,1646,257750,228703,304595,92005,42719,883053,True
"Orange County, California",06,059,2018,3164182,1032373,1601753,1562429,37.8,85398,553419.0,209411.0,59466.0,35342.0,1578079,84431,1662510,3.02,652900,1777,85119.0,926313.0,3554,711188,754603,1257903,440488,7744,3164182,True
"Ventura County, California",06,111,2018,848112,271226,428524,419588,37.9,84017,117739.0,47383.0,13410.0,9026.0,412228,25853,438081,3.08,559700,1705,30848.0,236018.0,887,199599,193979,331099,123435,22135,848112,True
"Calaveras County, California",06,009,2018,45235,17417,22801,22434,52.1,58151,4386.0,1512.0,373.0,203.0,17114,1116,18230,2.57,297700,1286,2973.0,13867.0,143,7768,6794,18459,12214,420,45235,True
"Sutter County, California",06,101,2018,95872,32360,48083,47789,35.7,56955,7345.0,2553.0,832.0,294.0,38664,4144,42808,2.93,260300,986,4979.0,26683.0,389,25116,21819,34709,14228,4120,95872,True
"San Mateo County, California",06,081,2018,765935,261969,388084,377851,39.6,113776,157556.0,74424.0,22332.0,19318.0,409911,17556,427467,2.89,994100,2158,21594.0,235722.0,915,161248,168784,318036,117867,1882,765935,True
"Tuolumne County, California",06,109,2018,53932,22427,25830,28102,48.4,56493,5286.0,1940.0,650.0,362.0,20930,1516,22446,2.25,278900,970,3980.0,17705.0,59,9013,10465,21103,13351,543,53932,True
"San Joaquin County, California",06,077,2018,732212,226727,367600,364612,34.1,61145,57633.0,18471.0,5442.0,2940.0,305509,28989,334498,3.16,313800,1159,37574.0,182916.0,2001,201506,173691,267554,89461,14231,732212,True
"Amador County, California",06,005,2018,37829,14090,17527,20302,50.5,61198,3910.0,1220.0,630.0,237.0,13289,1255,14544,2.42,296400,1056,2004.0,11645.0,80,5822,6231,15824,9952,483,37829,True
"Merced County, California",06,047,2019,271382,80008,134395,136987,31.1,53672,14630.0,5301.0,1286.0,901.0,104983,14137,119120,3.32,252700,1021,10737.0,67516.0,745,80459,69983,90984,29956,13477,271382,True
"Mariposa County, California",06,043,2019,17420,7643,8548,8872,51.7,48820,2169.0,793.0,224.0,162.0,7038,634,7672,2.13,275700,929,1512.0,5886.0,27,2840,2843,6947,4790,148,17420,True
"Modoc County, California",06,049,2019,8907,3616,4281,4626,47.8,45507,638.0,295.0,80.0,11.0,2957,278,3235,2.33,140600,717,986.0,2536.0,0,1752,1448,3306,2401,640,8907,True
"Contra Costa County, California",06,013,2019,1142251,394769,583749,558502,39.7,99716,206622.0,85966.0,24350.0,16460.0,559366,31392,590758,2.87,625800,1819,26150.0,362591.0,4708,261203,239145,466021,175882,2762,1142251,True
"Inyo County, California",06,027,2019,17977,7950,8915,9062,45.8,57316,2201.0,1085.0,155.0,146.0,8238,355,8593,2.18,269100,919,1273.0,6397.0,47,3609,3094,7177,4097,346,17977,True
"Stanislaus County, California",06,099,2019,543194,173898,274323,268871,34.1,60704,40630.0,11755.0,4290.0,1977.0,228175,22800,250975,3.09,291600,1155,23028.0,147966.0,1006,147623,130549,195343,69679,12667,543194,True
"Santa Barbara County, California",06,083,2019,444829,145856,222170,222659,33.8,74624,55474.0,24612.0,7129.0,6758.0,213438,13147,226585,2.91,577400,1643,13405.0,128775.0,608,99184,129755,149327,66563,18748,444829,True
"Tehama County, California",06,103,2019,63912,24189,32139,31773,41.0,44514,4864.0,1418.0,497.0,89.0,24633,2318,26951,2.61,215900,872,5056.0,18509.0,146,15258,12527,23820,12307,1777,63912,True
"Mono County, California",06,051,2019,14310,4765,6676,7634,37.7,62260,2084.0,489.0,167.0,121.0,8328,291,8619,2.93,312500,1206,607.0,4031.0,4,2671,3827,5763,2049,193,14310,True
"San Benito County, California",06,069,2019,60376,18135,30225,30151,35.7,86958,5294.0,1703.0,428.0,261.0,29347,2163,31510,3.31,551500,1535,1460.0,16411.0,211,15678,13877,23292,7529,1927,60376,True
"Sacramento County, California",06,067,2019,1524553,543025,779556,744997,36.2,67151,210144.0,72897.0,23313.0,10965.0,704151,49129,753280,2.76,351900,1252,51681.0,479284.0,1814,363176,371726,580055,209596,5542,1524553,True
"El Dorado County, California",06,017,2019,188563,70974,94641,93922,45.9,83377,31014.0,10480.0,3571.0,1930.0,85101,4917,90018,2.63,460900,1260,7177.0,62191.0,745,37922,32683,79388,38570,1022,188563,True
"Monterey County, California",06,053,2019,433410,127155,212409,221001,34.4,71015,40905.0,18092.0,5602.0,3507.0,187708,9696,197404,3.27,516600,1495,17374.0,107372.0,792,113869,106478,155823,57240,32519,433410,True
"San Francisco County, California",06,075,2019,874961,362354,428675,446286,38.2,112449,241699.0,107424.0,35058.0,19535.0,523501,23040,546541,2.36,1097800,1895,35640.0,318105.0,1003,117546,267446,354988,134981,907,874961,True
"San Diego County, California",06,073,2019,3316073,1125286,1646558,1669515,35.8,78980,533725.0,225220.0,64991.0,47846.0,1588732,101445,1690177,2.87,563700,1658,88423.0,1016635.0,13050,722738,892602,1246644,454089,11591,3316073,True
"Tulare County, California",06,107,2019,461898,138238,230932,230966,31.0,49687,26586.0,9274.0,2518.0,1319.0,178687,18841,197528,3.3,205000,942,26514.0,107781.0,1168,143158,112882,154327,51531,29737,461898,True
"Humboldt County, California",06,023,2019,135940,54679,68364,67576,38.4,48041,18745.0,6030.0,2085.0,1263.0,62030,5253,67283,2.41,313200,981,7475.0,45836.0,216,26137,35753,50532,23518,3055,135940,True
"Alpine County, California",06,003,2019,1039,350,485,554,52.2,63750,163.0,58.0,23.0,22.0,343,49,392,2.87,365300,538,35.0,301.0,15,201,134,393,311,26,1039,True
"Madera County, California",06,039,2019,155433,44881,80461,74972,34.1,57585,9917.0,3059.0,845.0,371.0,58268,5554,63822,3.28,251200,1014,7630.0,35975.0,408,42853,36604,54545,21431,8753,155433,True
"Santa Cruz County, California",06,087,2019,273962,95818,138328,135634,37.8,82234,42819.0,19835.0,5464.0,5393.0,136406,8264,144670,2.72,756600,1717,9689.0,83879.0,790,53121,74474,103212,43155,7430,273962,True
"Trinity County, California",06,105,2019,12700,5939,6165,6535,52.5,40846,1411.0,419.0,62.0,30.0,4465,432,4897,2.09,287700,799,1763.0,4077.0,15,2166,1711,5413,3410,317,12700,True
"Riverside County, California",06,065,2019,2411439,724893,1210479,1200960,35.6,67005,221322.0,90052.0,21490.0,15073.0,1032734,83356,1116090,3.28,350100,1375,79333.0,629915.0,5519,614149,572346,884369,340575,14008,2411439,True
"San Bernardino County, California",06,071,2019,2149031,636041,1079265,1069766,33.3,63362,183593.0,72885.0,16940.0,10066.0,914514,75886,990400,3.29,328200,1283,69639.0,538250.0,2799,571568,552375,783127,241961,5256,2149031,True
"Marin County, California",06,041,2019,259943,105432,132987,126956,46.8,115246,65371.0,29500.0,12434.0,5969.0,130747,5039,135786,2.4,995800,2069,6596.0,96487.0,632,52633,39547,111593,56170,809,259943,True
"Placer County, California",06,061,2019,385512,142855,197350,188162,42.0,89691,71518.0,24589.0,8330.0,2941.0,178325,7902,186227,2.67,471500,1542,11158.0,128427.0,1237,86331,71057,154352,73772,1209,385512,True
"Shasta County, California",06,089,2019,179212,71181,91165,88047,41.5,54667,18727.0,6098.0,2538.0,681.0,74134,4280,78414,2.47,252300,1039,11040.0,57633.0,248,38679,36875,67386,36272,1532,179212,True
"Solano County, California",06,095,2019,441829,149865,222011,219818,38.1,81472,56528.0,18104.0,4776.0,2328.0,206978,13191,220169,2.88,406900,1592,11356.0,135975.0,2093,98839,103829,171852,67309,2829,441829,True
"Colusa County, California",06,011,2019,21454,7227,10460,10994,35.3,59401,1523.0,343.0,119.0,67.0,9692,435,10127,2.94,265200,889,1262.0,5872.0,200,5842,4823,7707,3082,2544,21454,True
"Glenn County, California",06,021,2019,27976,10085,13758,14218,36.4,49633,1964.0,342.0,175.0,60.0,11279,635,11914,2.74,233200,835,2428.0,7273.0,70,7485,5964,10067,4460,2486,27976,True
"Butte County, California",06,007,2019,225817,85320,114082,111735,37.1,52537,26518.0,8461.0,3327.0,1843.0,96095,8462,104557,2.57,271700,1060,10018.0,73174.0,638,45439,61868,77825,40685,3722,225817,True
"Kings County, California",06,031,2019,150691,43452,67696,82995,31.8,57848,9430.0,2843.0,1058.0,299.0,54408,4496,58904,3.13,215900,990,7210.0,35131.0,508,41039,42107,52482,15063,7864,150691,True
"Plumas County, California",06,063,2019,18660,8450,9378,9282,52.3,55359,2141.0,1087.0,161.0,43.0,7733,439,8172,2.16,242300,916,1616.0,6634.0,35,3117,2838,7655,5050,357,18660,True
"San Luis Obispo County, California",06,079,2019,282165,105981,139159,143006,39.2,73518,41436.0,17012.0,5080.0,3284.0,131679,5530,137209,2.51,574000,1476,9746.0,93705.0,853,50176,75971,101171,54847,3736,282165,True
"Fresno County, California",06,019,2019,984521,307906,493375,491146,32.2,53969,84769.0,27427.0,11054.0,4669.0,407511,38876,446387,3.14,255000,998,51702.0,247727.0,4869,280844,250116,335784,117777,38958,984521,True
"Kern County, California",06,029,2019,887641,270282,432798,454843,31.6,53350,58968.0,20953.0,5222.0,2951.0,343445,37459,380904,3.17,213900,978,45836.0,216465.0,2496,258089,229165,305675,94712,41973,887641,True
"Orange County, California",06,059,2019,3168044,1037492,1604212,1563832,38.1,90234,564720.0,217133.0,61323.0,36910.0,1592151,77176,1669327,3.01,679300,1854,74254.0,944471.0,4407,704508,751173,1257258,455105,8378,3168044,True
"Ventura County, California",06,111,2019,847263,271040,428152,419111,38.1,88131,121499.0,48177.0,14027.0,8972.0,415752,22340,438092,3.08,588400,1776,27200.0,239530.0,1162,196787,193245,329603,127628,22007,847263,True
"Calaveras County, California",06,009,2019,45514,16942,22851,22663,52.0,63158,4260.0,1493.0,402.0,229.0,17223,1174,18397,2.66,319500,1339,2256.0,14165.0,163,7811,6959,18225,12519,484,45514,True
"Sutter County, California",06,101,2019,96109,32636,48243,47866,35.7,59050,7457.0,2926.0,839.0,202.0,39045,3531,42576,2.91,279400,1033,4825.0,27125.0,519,25059,21863,34769,14418,4291,96109,True
"San Mateo County, California",06,081,2019,767423,263543,388095,379328,39.7,122641,159607.0,77549.0,23033.0,20860.0,414747,16104,430851,2.87,1089400,2316,18921.0,240433.0,990,159504,170034,317008,120877,1959,767423,True
"Tuolumne County, California",06,109,2019,54045,22502,25933,28112,48.4,60108,5460.0,2045.0,649.0,317.0,20993,1156,22149,2.24,289200,1009,3314.0,18638.0,85,8987,10308,20923,13827,443,54045,True
"San Joaquin County, California",06,077,2019,742603,228567,372451,370152,34.3,64432,60276.0,19050.0,5726.0,2653.0,313129,26334,339463,3.17,342100,1208,32793.0,190449.0,2319,202701,175911,270910,93081,13924,742603,True
"Amador County, California",06,005,2019,38429,14594,17789,20640,50.5,62772,3979.0,1075.0,593.0,190.0,13665,1010,14675,2.38,313700,1103,1694.0,12488.0,79,5847,6404,15932,10246,556,38429,True
"Lake County, California",06,033,2019,64195,25660,32330,31865,45.6,47040,4659.0,1728.0,615.0,210.0,24304,2327,26631,2.46,219400,978,5356.0,19758.0,241,13400,11336,25126,14333,1400,64195,True
"Yuba County, California",06,115,2019,76360,26354,37410,38950,32.8,58054,5872.0,1730.0,439.0,152.0,29821,2297,32118,2.84,257100,1002,3653.0,22003.0,480,21078,19442,26465,9375,1103,76360,True
"Lassen County, California",06,035,2019,30818,9280,10486,20332,36.6,56352,2080.0,557.0,219.0,72.0,8611,598,9209,2.26,203000,956,1705.0,7394.0,29,4602,9908,11929,4379,531,30818,True
"Sonoma County, California",06,097,2019,499772,189374,255727,244045,42.1,81018,79864.0,30937.0,11027.0,5754.0,256074,11658,267732,2.59,609600,1621,14943.0,170228.0,1129,99190,105831,199838,94913,7227,499772,True
"Imperial County, California",06,025,2019,180701,44829,87949,92752,32.4,47622,11716.0,3829.0,904.0,311.0,60074,9924,69998,3.81,195800,830,8605.0,34963.0,131,51853,45285,60722,22841,5529,180701,True
"Alameda County, California",06,001,2019,1656754,577177,842239,814515,37.6,99406,320319.0,164717.0,35503.0,35566.0,862449,41725,904174,2.82,769300,1797,50627.0,514286.0,2333,344027,416084,672617,224026,2658,1656754,True
"Napa County, California",06,055,2019,139623,48705,70020,69603,41.3,88596,22816.0,7689.0,3183.0,1403.0,71141,3331,74472,2.78,635900,1700,4157.0,43501.0,340,29201,29389,55065,25968,3804,139623,True
"Sierra County, California",06,091,2019,3040,1319,1415,1625,54.8,52148,205.0,131.0,81.0,17.0,1268,71,1339,2.28,231400,972,281.0,992.0,0,482,409,1257,892,146,3040,True
"Yolo County, California",06,113,2019,217352,74296,111914,105438,31.0,70228,27562.0,13552.0,5403.0,6334.0,99367,6562,105929,2.81,424900,1324,6649.0,65778.0,1125,46026,73354,71576,26396,4094,217352,True
"Nevada County, California",06,057,2019,99244,40855,50297,48947,50.5,66096,18412.0,6997.0,1844.0,1054.0,44059,2133,46192,2.4,431000,1273,4679.0,35231.0,307,17099,15752,40139,26254,523,99244,True
"Mendocino County, California",06,045,2019,87224,34408,43982,43242,43.1,51416,9685.0,3480.0,1292.0,700.0,37689,3571,41260,2.47,377500,1146,5446.0,28141.0,170,18702,16360,33630,18532,2360,87224,True
"Los Angeles County, California",06,037,2019,10081570,3316795,5112188,4969382,36.5,68044,1460862.0,522777.0,165612.0,91828.0,4929863,319435,5249298,2.99,583200,1460,416636.0,2803857.0,9746,2214760,2603161,3927671,1335978,19015,10081570,True
"Santa Clara County, California",06,085,2019,1927470,640215,953048,974422,37.1,124055,369625.0,239068.0,37309.0,53518.0,999094,44635,1043729,2.95,984000,2268,38578.0,589320.0,3742,428382,473729,771185,254174,4755,1927470,True
"Siskiyou County, California",06,093,2019,43468,19240,21760,21708,47.8,45241,4859.0,1547.0,662.0,275.0,16538,1269,17807,2.23,198900,856,3255.0,15591.0,80,8826,7397,16513,10732,1861,43468,True
"Del Norte County, California",06,015,2019,27495,9945,12750,14745,39.5,45283,1711.0,683.0,270.0,243.0,9015,751,9766,2.47,218800,878,1493.0,7961.0,29,5920,5916,10932,4727,393,27495,True
"Alameda County, California",06,001,2020,1661584,573174,844443,817141,37.8,104888,332539.0,172444.0,35591.0,35153.0,867923,43126,911049,2.84,825300,1904,40625.0,522772.0,2587,341591,414505,674302,231186,2604,1661584,True
"Alpine County, California",06,003,2020,1159,397,540,619,47.6,85750,173.0,100.0,51.0,12.0,406,45,451,2.83,372500,639,22.0,358.0,19,252,142,428,337,25,1159,True
"Butte County, California",06,007,2020,223344,83879,112953,110391,36.9,54972,26874.0,8986.0,3516.0,2007.0,96056,7687,103743,2.59,304700,1087,8033.0,73862.0,848,44865,61237,76579,40663,3734,223344,True
"Colusa County, California",06,011,2020,21491,7329,10498,10993,35.4,59427,1577.0,343.0,63.0,58.0,9688,425,10113,2.9,274100,918,1359.0,5906.0,148,5863,4776,7710,3142,2260,21491,True
"Contra Costa County, California",06,013,2020,1147788,398299,586593,561195,39.9,103997,212718.0,89959.0,24722.0,16845.0,563813,32666,596479,2.86,655500,1928,21101.0,371693.0,5598,260191,238999,467020,181578,2728,1147788,True
"El Dorado County, California",06,017,2020,190345,73078,95572,94773,46.3,83710,32856.0,10498.0,3811.0,1854.0,85899,4197,90096,2.58,479800,1320,6718.0,65092.0,737,37911,32596,79420,40418,1073,190345,True
"Fresno County, California",06,019,2020,990204,310097,496148,494056,32.4,57109,89315.0,28590.0,11961.0,4745.0,408625,39697,448322,3.14,271000,1029,44580.0,257011.0,5637,281391,250005,337679,121129,35765,990204,True
"Humboldt County, California",06,023,2020,136101,54120,68563,67538,38.9,49235,19270.0,6231.0,1928.0,1341.0,61137,6074,67211,2.44,331300,1002,6447.0,46505.0,355,25945,35647,50222,24287,3052,136101,True
"Imperial County, California",06,025,2020,180580,45768,87971,92609,32.5,46222,12186.0,3424.0,1063.0,320.0,59490,9444,68934,3.73,206700,847,7187.0,37555.0,110,51772,45259,60243,23306,5539,180580,True
"Kern County, California",06,029,2020,892458,273556,435215,457243,31.9,54851,61882.0,22789.0,5657.0,2792.0,346787,34847,381634,3.15,226600,994,37882.0,229600.0,2812,258159,229554,306881,97864,40334,892458,True
"Kings County, California",06,031,2020,151090,43604,67880,83210,32.0,61556,9431.0,3008.0,1075.0,554.0,53687,4952,58639,3.14,227400,1030,6270.0,36415.0,568,40923,42109,52494,15564,8134,151090,True
"Lassen County, California",06,035,2020,30600,9172,10558,20042,36.8,56971,2033.0,462.0,214.0,116.0,8256,541,8797,2.26,207800,928,1400.0,7612.0,13,4937,9365,11877,4421,395,30600,True
"Madera County, California",06,039,2020,155925,44479,80618,75307,34.1,61924,10572.0,3046.0,948.0,346.0,58917,6270,65187,3.32,268500,1068,5647.0,37745.0,687,42781,36913,54373,21858,8742,155925,True
"Marin County, California",06,041,2020,259441,104900,132912,126529,47.1,121671,65503.0,30533.0,12355.0,6213.0,130038,6184,136222,2.41,1053600,2170,5235.0,97855.0,600,51974,39422,110211,57834,962,259441,True
"Mariposa County, California",06,043,2020,17319,7846,8389,8930,51.8,50960,2440.0,945.0,153.0,121.0,6914,661,7575,2.06,290200,1010,1279.0,6304.0,33,2844,2704,6890,4881,226,17319,True
"Mendocino County, California",06,045,2020,87110,34164,44003,43107,43.4,52915,9143.0,3789.0,1349.0,596.0,37369,3536,40905,2.48,388500,1134,4861.0,28351.0,232,18592,16373,32911,19234,2413,87110,True
"Merced County, California",06,047,2020,273661,81306,135433,138228,31.2,56330,15580.0,4997.0,1419.0,877.0,107059,12819,119878,3.29,268800,1054,8737.0,71337.0,766,80729,70775,91392,30765,12689,273661,True
"Modoc County, California",06,049,2020,8853,3594,4349,4504,47.6,51250,821.0,292.0,99.0,8.0,3166,290,3456,2.33,153600,757,772.0,2708.0,0,1743,1456,3227,2427,646,8853,True
"Monterey County, California",06,053,2020,432977,128003,212558,220419,34.7,76943,43698.0,19119.0,5973.0,3802.0,188734,10084,198818,3.25,559400,1600,13391.0,112565.0,983,113350,105151,155415,59061,29856,432977,True
"Napa County, California",06,055,2020,138572,48484,69522,69050,41.8,92219,23922.0,7916.0,3355.0,1266.0,70752,3350,74102,2.78,666900,1775,3514.0,43957.0,366,28555,29011,54396,26610,3477,138572,True
"Nevada County, California",06,057,2020,99417,40917,50474,48943,50.5,68333,18883.0,6941.0,1853.0,1071.0,44843,1851,46694,2.4,446100,1315,4037.0,36137.0,304,17000,15554,39613,27250,649,99417,True
"Orange County, California",06,059,2020,3170345,1040001,1605768,1564577,38.3,94441,575866.0,223208.0,64671.0,36662.0,1592877,83099,1675976,3.01,703800,1928,63057.0,958758.0,5533,697715,748224,1255564,468842,9046,3170345,True
"Placer County, California",06,061,2020,391799,145714,200408,191391,42.2,93677,74031.0,26834.0,8700.0,2957.0,182516,7917,190433,2.66,495900,1616,9730.0,132830.0,1453,87116,71642,156423,76618,1080,391799,True
"Plumas County, California",06,063,2020,18844,8332,9396,9448,51.9,57233,2273.0,1092.0,134.0,67.0,7754,524,8278,2.21,259300,944,1232.0,6835.0,31,3172,2996,7459,5217,417,18844,True
"Riverside County, California",06,065,2020,2437864,736413,1222631,1215233,35.8,70732,236902.0,93993.0,23271.0,14974.0,1050497,82367,1132864,3.26,368100,1447,61872.0,658988.0,7117,613823,576550,895116,352375,12858,2437864,True
"Sacramento County, California",06,067,2020,1537948,547519,785850,752098,36.4,70684,214265.0,76386.0,25570.0,11830.0,715240,48974,764214,2.77,373000,1333,41297.0,496049.0,2315,363852,373235,584342,216519,5043,1537948,True
"San Benito County, California",06,069,2020,61547,18389,30562,30985,35.7,85808,5857.0,1542.0,447.0,195.0,29575,2409,31984,3.33,588500,1533,1316.0,16859.0,319,15844,14233,23658,7812,1917,61547,True
"San Bernardino County, California",06,071,2020,2162532,640090,1085931,1076601,33.6,65761,190544.0,74473.0,17044.0,10176.0,926877,72961,999838,3.3,348500,1338,56066.0,560825.0,3625,570845,554315,787340,250032,5217,2162532,True
"San Diego County, California",06,073,2020,3323970,1130703,1649458,1674512,36.1,82426,547105.0,231841.0,65763.0,48939.0,1589275,104435,1693710,2.86,595600,1732,71934.0,1039972.0,15857,718250,888729,1249254,467737,11231,3323970,True
"San Francisco County, California",06,075,2020,874784,362141,428538,446246,38.3,119136,244101.0,110519.0,35273.0,19448.0,521465,25625,547090,2.36,1152300,2010,29449.0,324575.0,1116,117363,265858,353406,138157,745,874784,True
"San Joaquin County, California",06,077,2020,751615,231092,376974,374641,34.4,68628,61634.0,21067.0,5682.0,2725.0,319808,24994,344802,3.18,367900,1286,26399.0,199545.0,2718,203670,177851,274145,95949,14252,751615,True
"San Luis Obispo County, California",06,079,2020,282517,106244,139582,142935,39.5,77948,42392.0,17401.0,5807.0,2935.0,131426,6154,137580,2.51,605200,1535,8700.0,95071.0,979,49949,75335,100533,56700,3596,282517,True
"San Mateo County, California",06,081,2020,765623,263351,386376,379247,39.8,128091,162985.0,79579.0,23199.0,22119.0,413687,17209,430896,2.87,1163100,2435,15578.0,244069.0,951,156769,170330,314707,123817,2018,765623,True
"Santa Clara County, California",06,085,2020,1924379,635314,949638,974741,37.2,130890,374303.0,247493.0,37780.0,57358.0,1003304,44527,1047831,2.97,1061900,2386,32536.0,592128.0,4425,421988,474347,768056,259988,4720,1924379,True
"Santa Cruz County, California",06,087,2020,273170,96275,137937,135233,38.2,89986,43990.0,20913.0,5518.0,5014.0,137107,8880,145987,2.7,787000,1843,7171.0,87157.0,896,52286,74088,101883,44913,6620,273170,True
"Sierra County, California",06,091,2020,2898,1250,1424,1474,54.0,52103,202.0,164.0,71.0,9.0,1296,98,1394,2.29,229400,1032,230.0,946.0,0,444,384,1253,817,171,2898,True
"Solano County, California",06,095,2020,444538,151191,223308,221230,38.3,84638,56808.0,19083.0,4948.0,2302.0,209436,13075,222511,2.87,437900,1684,9578.0,139106.0,2633,98625,103855,172090,69968,2636,444538,True
"Sonoma County, California",06,097,2020,496801,188958,254144,242657,42.4,86173,82070.0,31999.0,11346.0,5419.0,253919,12297,266216,2.58,640000,1743,12642.0,172720.0,1508,97601,104097,197642,97461,5946,496801,True
"Sutter County, California",06,101,2020,96315,32586,48225,48090,35.8,63502,8301.0,2921.0,987.0,427.0,40468,3374,43842,2.92,306000,1095,4086.0,27944.0,578,24979,21856,34689,14791,3763,96315,True
"Tehama County, California",06,103,2020,64176,24661,32327,31849,40.6,48895,5566.0,1501.0,550.0,81.0,24951,2427,27378,2.57,231500,972,3994.0,19931.0,204,15329,12467,23673,12707,1622,64176,True
"Tulare County, California",06,107,2020,463955,139044,231997,231958,31.2,52534,26811.0,9559.0,2532.0,945.0,183876,20214,204090,3.3,223600,974,21867.0,113948.0,1111,142777,112995,155357,52826,28534,463955,True
"Tuolumne County, California",06,109,2020,54147,22937,26124,28023,48.7,60509,6019.0,2318.0,569.0,346.0,20909,1646,22555,2.21,314300,1025,2968.0,19374.0,185,8986,10443,20609,14109,470,54147,True
"Yolo County, California",06,113,2020,218774,74614,112772,106002,31.1,73746,28050.0,14484.0,5707.0,6582.0,100638,5953,106591,2.82,456800,1369,5783.0,66967.0,1364,45977,73917,71566,27314,4034,218774,True
"Yuba County, California",06,115,2020,77524,26434,38177,39347,33.0,59424,6196.0,2036.0,340.0,243.0,29508,2257,31765,2.88,273600,1015,3023.0,22805.0,467,21355,19556,27025,9588,1266,77524,True
"Mono County, California",06,051,2020,14395,5196,6688,7707,39.5,64924,2152.0,478.0,510.0,68.0,8051,202,8253,2.7,385500,1248,433.0,4623.0,2,2983,3257,5957,2198,162,14395,True
"Amador County, California",06,005,2020,39023,14844,17944,21079,49.9,65187,3797.0,939.0,660.0,177.0,14280,853,15133,2.39,329300,1057,1812.0,12555.0,139,5962,6563,15961,10537,554,39023,True
"Calaveras County, California",06,009,2020,45828,16958,22919,22909,52.8,67054,4774.0,1477.0,482.0,278.0,17264,949,18213,2.67,340000,1354,1977.0,14387.0,152,7618,6928,18442,12840,576,45828,True
"Del Norte County, California",06,015,2020,27692,9805,12947,14745,40.0,49981,1870.0,732.0,295.0,145.0,9161,625,9786,2.54,227500,946,1192.0,8216.0,39,6003,5791,10974,4924,544,27692,True
"Glenn County, California",06,021,2020,28060,10216,13692,14368,35.9,51682,2054.0,334.0,156.0,66.0,11840,712,12552,2.72,242200,810,2281.0,7574.0,99,7491,6092,9884,4593,2614,28060,True
"Inyo County, California",06,027,2020,17930,7954,8691,9239,45.3,59296,2161.0,1008.0,111.0,186.0,8061,330,8391,2.18,258200,938,1111.0,6622.0,35,3722,2988,7048,4172,286,17930,True
"Lake County, California",06,033,2020,64276,25508,32177,32099,45.3,49254,5159.0,1745.0,607.0,259.0,23924,2819,26743,2.48,238000,1028,4319.0,20721.0,207,13528,11113,24950,14685,1453,64276,True
"Los Angeles County, California",06,037,2020,10040682,3332504,5091117,4949565,36.7,71358,1506714.0,542385.0,173552.0,95031.0,4908826,338720,5247546,2.96,615500,1534,343655.0,2904482.0,11378,2178559,2582242,3909740,1370141,18493,10040682,True
"Santa Barbara County, California",06,083,2020,444895,148309,222371,222524,33.8,78925,57549.0,24717.0,7184.0,7097.0,212400,12848,225248,2.86,610300,1697,10978.0,133741.0,659,99039,129493,148343,68020,17865,444895,True
"Shasta County, California",06,089,2020,179267,70845,91115,88152,41.7,57139,18808.0,6192.0,2413.0,684.0,73991,4646,78637,2.48,261000,1075,8423.0,60393.0,362,38668,36642,67034,36923,1469,179267,True
"Siskiyou County, California",06,093,2020,43516,19195,21858,21658,47.7,47403,4593.0,1643.0,581.0,211.0,16597,1325,17922,2.24,214300,878,2892.0,15878.0,110,8800,7366,16367,10983,1614,43516,True
"Stanislaus County, California",06,099,2020,546235,174826,275703,270532,34.3,62873,42776.0,12207.0,4379.0,1950.0,231043,22357,253400,3.09,314100,1210,20281.0,151610.0,1138,148177,131088,195740,71230,11906,546235,True
"Trinity County, California",06,105,2020,12541,5896,6172,6369,52.4,41780,1223.0,370.0,89.0,186.0,4193,417,4610,2.08,285700,813,1463.0,4219.0,4,2161,1693,5180,3507,295,12541,True
"Ventura County, California",06,111,2020,845599,271639,427008,418591,38.5,89295,123510.0,48132.0,13746.0,8851.0,411295,22114,433409,3.06,609200,1854,23433.0,243871.0,1417,193847,192040,328040,131672,20239,845599,True
"Alameda County, California",06,001,2021,1673133,581683,845577,827556,38.0,112017,337847.0,181206.0,36650.0,36967.0,874563,46498,921061,2.82,870100,2043,35577.0,537172.0,3069,344088,408580,686469,233996,2716,1673133,True
"Alpine County, California",06,003,2021,1344,434,613,731,48.2,96000,200.0,84.0,56.0,41.0,522,53,575,3.01,378200,-666666666,23.0,385.0,22,289,186,490,379,30,1344,True
"Amador County, California",06,005,2021,40095,15394,18135,21960,49.7,69955,4317.0,1119.0,583.0,173.0,15114,1099,16213,2.38,349500,1126,1613.0,13383.0,207,6114,6725,16552,10704,523,40095,True
"Butte County, California",06,007,2021,217884,85292,109716,108168,36.6,59863,27819.0,9170.0,3507.0,1813.0,96203,7446,103649,2.48,325600,1172,7116.0,76141.0,1098,44310,59591,74789,39194,3760,217884,True
"Calaveras County, California",06,009,2021,45349,16809,22775,22574,52.3,70119,4876.0,1439.0,412.0,232.0,16631,1215,17846,2.67,354600,1430,1728.0,14498.0,248,7722,6764,18146,12717,645,45349,True
"Colusa County, California",06,011,2021,21780,7303,10638,11142,35.6,61861,1558.0,361.0,75.0,49.0,9538,559,10097,2.95,300500,974,1360.0,5786.0,179,5936,4771,7902,3171,2009,21780,True
"Contra Costa County, California",06,013,2021,1161643,405106,590637,571006,39.9,110455,218293.0,93424.0,25108.0,17836.0,570386,35366,605752,2.84,689000,2061,18230.0,381325.0,6319,263508,238382,475722,184031,2821,1161643,True
"Del Norte County, California",06,015,2021,27655,9531,12894,14761,40.1,53280,2070.0,743.0,223.0,140.0,9245,750,9995,2.62,237700,999,835.0,8449.0,44,5990,5720,11004,4941,604,27655,True
"El Dorado County, California",06,017,2021,190568,74535,95363,95205,46.2,88770,34494.0,11238.0,3892.0,1739.0,87325,4295,91620,2.53,510200,1409,6155.0,67292.0,912,38068,32337,79282,40881,1225,190568,True
"Fresno County, California",06,019,2021,1003150,314421,500456,502694,32.6,61276,93209.0,29946.0,12040.0,4988.0,415669,40039,455708,3.14,288100,1098,40770.0,263809.0,6719,286311,249380,345619,121840,37123,1003150,True
"Glenn County, California",06,021,2021,28675,9753,14126,14549,35.5,56332,2226.0,353.0,74.0,72.0,12172,924,13096,2.91,262600,954,1533.0,8075.0,189,7769,6290,9979,4637,2351,28675,True
"Humboldt County, California",06,023,2021,137014,53729,68610,68404,39.1,53350,19376.0,6442.0,2137.0,1308.0,60195,6223,66418,2.48,344800,1079,5523.0,47295.0,286,26244,35269,50734,24767,3250,137014,True
"Imperial County, California",06,025,2021,180051,45541,87362,92689,32.5,49078,12239.0,3297.0,941.0,281.0,58404,9461,67865,3.73,219800,892,5706.0,38931.0,62,51865,44475,60630,23081,5383,180051,True
"Inyo County, California",06,027,2021,18804,7832,9258,9546,44.5,60925,2217.0,1163.0,155.0,214.0,8356,377,8733,2.31,291400,988,1070.0,6516.0,35,3996,3094,7356,4358,259,18804,True
"Kern County, California",06,029,2021,905644,274705,439805,465839,32.1,58824,63839.0,24163.0,6185.0,3049.0,353637,34404,388041,3.19,241400,1063,32690.0,236173.0,3710,262988,229761,313875,99020,41115,905644,True
"Kings County, California",06,031,2021,151887,43286,68015,83872,32.1,63267,9159.0,2945.0,883.0,511.0,52477,5259,57736,3.17,243300,1098,5554.0,36932.0,647,41348,41723,53162,15654,8398,151887,True
"Lake County, California",06,033,2021,67749,26307,33693,34056,44.6,53399,5747.0,1915.0,592.0,303.0,25509,2860,28369,2.54,260600,1116,3762.0,21944.0,272,14489,11848,26054,15358,1442,67749,True
"Lassen County, California",06,035,2021,32949,8910,11588,21361,37.3,59292,2098.0,391.0,259.0,115.0,8639,640,9279,2.58,211300,969,1240.0,7538.0,13,5416,9622,13055,4856,435,32949,True
"Los Angeles County, California",06,037,2021,10019635,3342811,5055907,4963728,37.0,76367,1530075.0,553854.0,175089.0,97554.0,4885032,367715,5252747,2.94,647000,1653,289919.0,2976225.0,13107,2169083,2534428,3943907,1372217,19293,10019635,True
"Madera County, California",06,039,2021,156304,43578,80293,76011,34.3,66709,11366.0,3283.0,1005.0,490.0,58744,6859,65603,3.4,284800,1120,4620.0,38063.0,753,43188,36256,55207,21653,8504,156304,True
"Marin County, California",06,041,2021,262387,103751,133243,129144,47.1,131008,65270.0,30810.0,13508.0,6319.0,130613,7097,137710,2.46,1118300,2307,4424.0,97354.0,625,52454,39887,111370,58676,1035,262387,True
"Mariposa County, California",06,043,2021,17225,7588,8410,8815,51.6,53304,2624.0,957.0,192.0,128.0,7040,756,7796,2.12,302600,1058,1105.0,6258.0,68,2896,2767,6701,4861,225,17225,True
"Mendocino County, California",06,045,2021,91534,34183,46010,45524,43.6,56378,9612.0,4312.0,1367.0,671.0,38972,3606,42578,2.61,417100,1176,4440.0,28731.0,280,19587,16819,34631,20497,2520,91534,True
"Merced County, California",06,047,2021,279150,81618,137444,141706,31.3,58861,15979.0,5065.0,1388.0,827.0,108194,13492,121686,3.35,288400,1125,7429.0,72405.0,985,82578,71531,94053,30988,12253,279150,True
"Modoc County, California",06,049,2021,8723,3413,4335,4388,47.8,51090,864.0,320.0,80.0,29.0,2993,328,3321,2.42,152400,748,737.0,2607.0,0,1709,1503,3058,2453,620,8723,True
"Mono County, California",06,051,2021,13291,5361,6007,7284,40.3,71138,1833.0,452.0,446.0,73.0,7097,178,7275,2.42,390100,1228,256.0,4866.0,2,2647,2810,5843,1991,196,13291,True
"Monterey County, California",06,053,2021,438953,129977,214658,224295,34.9,82013,44514.0,19979.0,5981.0,3837.0,189807,11019,200826,3.24,596400,1718,9860.0,117899.0,1056,115434,104556,159024,59939,29444,438953,True
"Napa County, California",06,055,2021,138795,48745,69255,69540,42.1,97498,24141.0,7850.0,3171.0,1302.0,70147,3603,73750,2.77,685500,1880,2978.0,44809.0,438,28404,28743,54893,26755,3378,138795,True
"Nevada County, California",06,057,2021,102090,40877,51513,50577,50.1,74617,19385.0,7595.0,2182.0,1229.0,46744,2042,48786,2.47,474100,1380,3746.0,36494.0,366,17577,15866,40623,28024,680,102090,True
"Orange County, California",06,059,2021,3182923,1057592,1604231,1578692,38.5,100485,585008.0,233094.0,67813.0,39449.0,1596831,91539,1688370,2.97,738100,2057,55925.0,984196.0,6345,699691,740513,1270304,472415,9490,3182923,True
"Placer County, California",06,061,2021,400330,149714,203418,196912,42.1,99734,76411.0,28359.0,9227.0,3254.0,185819,8303,194122,2.65,539400,1734,8568.0,137920.0,1704,89446,72358,160756,77770,1290,400330,True
"Plumas County, California",06,063,2021,19631,8231,9718,9913,51.8,57885,2233.0,958.0,161.0,112.0,7760,697,8457,2.34,268900,1031,1122.0,6867.0,36,3421,3026,7638,5546,409,19631,True
"Riverside County, California",06,065,2021,2409331,740506,1201934,1207397,36.0,76066,238066.0,95317.0,22386.0,14363.0,1045030,81362,1126392,3.2,390400,1552,51769.0,673262.0,8215,606535,563164,894154,345478,12671,2409331,True
"Sacramento County, California",06,067,2021,1571767,559036,798959,772808,36.6,76422,221577.0,80182.0,27086.0,12860.0,732788,51448,784236,2.77,398300,1434,35011.0,514458.0,2809,372547,375839,602281,221100,5569,1571767,True
"San Benito County, California",06,069,2021,63329,19144,31323,32006,35.7,95606,6305.0,1503.0,383.0,269.0,30951,2379,33330,3.29,623000,1703,1276.0,17660.0,495,16452,14409,24402,8066,1898,63329,True
"San Bernardino County, California",06,071,2021,2171071,651743,1085470,1085601,33.8,70287,197308.0,77272.0,16492.0,10819.0,934832,75447,1010279,3.26,370700,1427,47922.0,582935.0,4775,573984,549527,796653,250907,4960,2171071,True
"San Diego County, California",06,073,2021,3296317,1139899,1628153,1668164,36.3,88240,552537.0,237251.0,64813.0,51854.0,1572927,110391,1683318,2.81,627200,1842,59974.0,1061689.0,17463,713838,866039,1251576,464864,10298,3296317,True
"San Francisco County, California",06,075,2021,865933,361222,422280,443653,38.7,126187,243795.0,110417.0,35420.0,20420.0,511902,28573,540475,2.34,1194500,2130,25524.0,327731.0,1182,118194,254432,355354,137953,821,865933,True
"San Joaquin County, California",06,077,2021,771406,234662,385149,386257,34.6,74962,64170.0,21608.0,6014.0,3291.0,327491,25714,353205,3.21,391500,1387,22582.0,206756.0,3261,209515,180607,283761,97523,15458,771406,True
"San Luis Obispo County, California",06,079,2021,282771,106790,139128,143643,39.7,82514,43001.0,17670.0,6143.0,3106.0,130139,7059,137198,2.5,630600,1654,7346.0,97098.0,1173,50215,74626,100696,57234,3942,282771,True
"San Mateo County, California",06,081,2021,762488,264892,382862,379626,40.0,136837,162209.0,80466.0,22764.0,23962.0,409344,19757,429101,2.84,1225900,2599,13505.0,247932.0,1088,155785,167106,315728,123869,1849,762488,True
"Santa Barbara County, California",06,083,2021,447651,147446,222637,225014,33.9,84356,58791.0,24596.0,7239.0,7010.0,211109,13803,224912,2.89,625200,1810,9535.0,134325.0,811,100508,128972,149950,68221,17223,447651,True
"Santa Clara County, California",06,085,2021,1932022,646847,948198,983824,37.5,140258,375482.0,258731.0,39036.0,60701.0,1007768,46957,1054725,2.93,1134400,2530,27636.0,609701.0,5321,422063,470169,777901,261889,4904,1932022,True
"Santa Cruz County, California",06,087,2021,272138,96476,136707,135431,38.5,96093,43339.0,21042.0,5697.0,5320.0,136507,9311,145818,2.69,826500,1925,6030.0,88509.0,937,51985,73116,101252,45785,6690,272138,True
"Shasta County, California",06,089,2021,181935,71314,91994,89941,41.5,61937,19506.0,6444.0,2379.0,712.0,75545,5274,80819,2.51,281600,1140,7024.0,62300.0,510,39623,36821,68311,37180,1427,181935,True
"Sierra County, California",06,091,2021,3079,1151,1638,1441,45.9,56152,259.0,140.0,116.0,0.0,1387,137,1524,2.65,231400,978,199.0,850.0,0,475,564,1185,855,198,3079,True
"Siskiyou County, California",06,093,2021,44151,18598,21933,22218,47.1,49857,4595.0,1630.0,465.0,243.0,16554,1414,17968,2.34,229600,893,2599.0,15525.0,115,8981,7363,16557,11250,1525,44151,True
"Solano County, California",06,095,2021,451432,153632,225553,225879,38.5,89648,58967.0,19908.0,5418.0,2688.0,212151,13430,225581,2.87,464000,1802,8226.0,142735.0,2928,100496,103557,175686,71693,2188,451432,True
"Sonoma County, California",06,097,2021,492498,188841,250600,241898,42.5,91607,82579.0,32790.0,11634.0,5342.0,251382,13428,264810,2.56,665800,1856,10343.0,175057.0,1711,96796,101333,196554,97815,6124,492498,True
"Stanislaus County, California",06,099,2021,550842,175067,276477,274365,34.4,68368,42993.0,12737.0,4558.0,2301.0,234325,21517,255842,3.12,338300,1315,16406.0,155662.0,1405,150291,130646,198560,71345,11456,550842,True
"Sutter County, California",06,101,2021,99080,32703,49302,49778,35.8,67003,8650.0,2961.0,913.0,447.0,41668,3431,45099,3.0,326300,1167,3746.0,28425.0,665,25779,22407,35831,15063,3578,99080,True
"Tehama County, California",06,103,2021,65345,24551,32815,32530,40.0,52901,5587.0,1452.0,507.0,81.0,26019,2297,28316,2.63,243600,1028,3421.0,20377.0,285,15739,12749,24063,12794,2092,65345,True
"Trinity County, California",06,105,2021,15818,5492,7739,8079,53.9,42206,1443.0,566.0,76.0,239.0,5413,332,5745,2.83,300800,869,1104.0,4228.0,5,2573,2281,6574,4390,564,15818,True
"Tulare County, California",06,107,2021,470999,139631,234574,236425,31.3,57394,28347.0,10735.0,2472.0,778.0,187269,21293,208562,3.33,240600,1037,19327.0,116542.0,1018,145107,113606,159156,53130,28450,470999,True
"Tuolumne County, California",06,109,2021,55243,23103,26488,28755,48.6,66846,6817.0,2441.0,768.0,370.0,21541,1896,23437,2.24,333500,1105,2737.0,19786.0,303,9388,10300,21107,14448,457,55243,True
"Ventura County, California",06,111,2021,845255,274471,424655,420600,38.7,94150,124047.0,48602.0,13872.0,9090.0,410141,24236,434377,3.03,633900,1976,19217.0,250506.0,1499,193250,189641,329877,132487,19406,845255,True
"Yolo County, California",06,113,2021,216703,75471,111335,105368,31.5,78386,28159.0,14518.0,5726.0,6596.0,101603,6017,107620,2.77,476000,1475,5071.0,68429.0,1865,45449,72655,71440,27159,3681,216703,True
"Yuba County, California",06,115,2021,80404,26888,39703,40701,33.2,62666,5955.0,2297.0,499.0,267.0,30557,2136,32693,2.94,286000,1060,2658.0,23657.0,478,22298,19963,28132,10011,1348,80404,True
